Nematopogon_stenochlora	Adelidae
Nematopogon_robertella	Adelidae
Cauchas_breviantennella	Adelidae
Adela_croesella	Adelidae
Nematopogon_adansoniella	Adelidae
Nematopogon_magna	Adelidae
Nemophora_associatella	Adelidae
Adela_australis	Adelidae
Adela_reaumurella	Adelidae
Nematopogon_pilella	Adelidae
Nemophora_dumerilella	Adelidae
Adela_violella	Adelidae
Adela_albicinctella	Adelidae
Adela_cuprella	Adelidae
Nematopogon_swammerdamella	Adelidae
Nemophora_pfeifferella	Adelidae
Cauchas_fibulella	Adelidae
Cauchas_rufifrontella	Adelidae
Nemophora_fasciella	Adelidae
Nemophora_minimella	Adelidae
Nemophora_amatella	Adelidae
Nemophora_bellela	Adelidae
Nemophora_degeerella	Adelidae
Adela_mazzolella	Adelidae
Nematopogon_metaxella	Adelidae
Nematopogon_schwarziellus	Adelidae
Nemophora_metallica	Adelidae
Nemophora_congruella	Adelidae
Nemophora_ochsenheimerella	Adelidae
Cauchas_rufimitrella	Adelidae
Nemophora_raddaella	Adelidae
Cauchas_leucocerella	Adelidae
Cauchas_albiantennella	Adelidae
Nemophora_violellus	Adelidae
Nemophora_cupriacella	Adelidae
Argyresthia_retinella	Argyresthiidae
Argyresthia_brockeella	Argyresthiidae
Argyresthia_goedartella	Argyresthiidae
Argyresthia_fundella	Argyresthiidae
Argyresthia_praecocella	Argyresthiidae
Argyresthia_glaucinella	Argyresthiidae
Argyresthia_pulchella	Argyresthiidae
Argyresthia_aurulentella	Argyresthiidae
Argyresthia_conjugella	Argyresthiidae
Argyresthia_dilectella	Argyresthiidae
Argyresthia_albistria	Argyresthiidae
Argyresthia_glabratella	Argyresthiidae
Argyresthia_thuiella	Argyresthiidae
Argyresthia_svenssoni	Argyresthiidae
Argyresthia_abdominalis	Argyresthiidae
Argyresthia_submontana	Argyresthiidae
Argyresthia_sorbiella	Argyresthiidae
Argyresthia_pruniella	Argyresthiidae
Argyresthia_bonnetella	Argyresthiidae
Argyresthia_pygmaeella	Argyresthiidae
Argyresthia_curvella	Argyresthiidae
Argyresthia_spinosella	Argyresthiidae
Argyresthia_illuminatella	Argyresthiidae
Argyresthia_arceuthina	Argyresthiidae
Argyresthia_trifasciata	Argyresthiidae
Argyresthia_semitestacella	Argyresthiidae
Argyresthia_semifusca	Argyresthiidae
Argyresthia_laevigatella	Argyresthiidae
Argyresthia_bergiella	Argyresthiidae
Heringita_heringi	Autostichidae
Symmoca_tofosella	Autostichidae
Apatema_apolausticum	Autostichidae
Oegoconia_novimundi	Autostichidae
Apatema_mediopallidum	Autostichidae
Symmoca_perobscurata	Autostichidae
Orpecovalva_glaseri	Autostichidae
Dysspastus_fallax	Autostichidae
Apatema_baixerasi	Autostichidae
Apatema_whalleyi	Autostichidae
Oegoconia_caradjai	Autostichidae
Oegoconia_quadripuncta	Autostichidae
Oegoconia_deauratella	Autostichidae
Oegoconia_uralskella	Autostichidae
Symmoca_achrestella	Autostichidae
Symmoca_albicanella	Autostichidae
Symmoca_signella	Autostichidae
Symmoca_caliginella	Autostichidae
Symmoca_dolomitana	Autostichidae
Symmoca_senora	Autostichidae
Symmoca_dodecatella	Autostichidae
Symmoca_signatella	Autostichidae
Symmoca_uniformella	Autostichidae
Stibaromacha_ratella	Autostichidae
Blastobasis_tarda	Blastobasiidae
Blastobasis_phycidella	Blastobasiidae
Blastobasis_pannonica	Blastobasiidae
Blastobasis_desertarum	Blastobasiidae
Blastobasis_maroccanella	Blastobasiidae
Blastobasis_adustella	Blastobasiidae
Blastobasis_lacticolella	Blastobasiidae
Blastobasis_nigromaculata	Blastobasiidae
Blastobasis_luteella	Blastobasiidae
Blastobasis_decolorella	Blastobasiidae
Blastobasis_glandulella	Blastobasiidae
Hypatopa_segnella	Blastobasiidae
Hypatopa_inunctella	Blastobasiidae
Hypatopa_binotella	Blastobasiidae
Bucculatrix_frangutella	Bucculatricidae
Bucculatrix_albedinella	Bucculatricidae
Bucculatrix_ulmella	Bucculatricidae
Bucculatrix_artemisiella	Bucculatricidae
Bucculatrix_cristatella	Bucculatricidae
Bucculatrix_ratisbonensis	Bucculatricidae
Bucculatrix_ainsliella	Bucculatricidae
Bucculatrix_bechsteinella	Bucculatricidae
Bucculatrix_benacicolella	Bucculatricidae
Bucculatrix_thoracella	Bucculatricidae
Bucculatrix_maritima	Bucculatricidae
Bucculatrix_latviaella	Bucculatricidae
Bucculatrix_atagina	Bucculatricidae
Bucculatrix_nigricomella	Bucculatricidae
Bucculatrix_argentisignella	Bucculatricidae
Bucculatrix_demaryella	Bucculatricidae
Bucculatrix_cidarella	Bucculatricidae
Bucculatrix_humiliella	Bucculatricidae
Bucculatrix_fatigatella	Bucculatricidae
Tebenna_bjerkandrella	Choreutidae
Tebenna_pretiosana	Choreutidae
Choreutis_nemorana	Choreutidae
Tebenna_micalis	Choreutidae
Choreutis_diana	Choreutidae
Choreutis_pariana	Choreutidae
Anthophila_fabriciana	Choreutidae
Prochoreutis_stellaris	Choreutidae
Prochoreutis_ultimana	Choreutidae
Prochoreutis_sehestediana	Choreutidae
Prochoreutis_myllerana	Choreutidae
Prochoreutis_solaris	Choreutidae
Prochoreutis_holotoxa	Choreutidae
Pterolonche_inspersa	Coleophoridae
Coleophora_algeriensis	Coleophoridae
Coleophora_calycotomella	Coleophoridae
Coleophora_traugotti	Coleophoridae
Coleophora_trigeminella	Coleophoridae
Metriotes_lutarea	Coleophoridae
Coleophora_albella	Coleophoridae
Coleophora_gryphipennella	Coleophoridae
Coleophora_trifolii	Coleophoridae
Coleophora_uliginosella	Coleophoridae
Coleophora_siccifolia	Coleophoridae
Coleophora_milvipennis	Coleophoridae
Coleophora_limosipennella	Coleophoridae
Coleophora_alnifoliae	Coleophoridae
Coleophora_badiipennella	Coleophoridae
Coleophora_flavipennella	Coleophoridae
Coleophora_hemerobiella	Coleophoridae
Coleophora_microalbella	Coleophoridae
Goniodoma_limoniella	Coleophoridae
Coleophora_ballotella	Coleophoridae
Coleophora_alcyonipennella	Coleophoridae
Coleophora_frischella	Coleophoridae
Ischnophanes_excentra	Coleophoridae
Coleophora_flaviella	Coleophoridae
Coleophora_coronillae	Coleophoridae
Coleophora_vermiculatella	Coleophoridae
Goniodoma_nemesi	Coleophoridae
Goniodoma_auroguttella	Coleophoridae
Coleophora_crepidinella	Coleophoridae
Coleophora_mausolella	Coleophoridae
Coleophora_pennella	Coleophoridae
Coleophora_lacera	Coleophoridae
Coleophora_dignella	Coleophoridae
Coleophora_stramentella	Coleophoridae
Coleophora_gallipennella	Coleophoridae
Coleophora_impalella	Coleophoridae
Coleophora_striolatella	Coleophoridae
Coleophora_basimaculella	Coleophoridae
Coleophora_parvicuprella	Coleophoridae
Coleophora_deauratella	Coleophoridae
Coleophora_spiraeella	Coleophoridae
Coleophora_lutipennella	Coleophoridae
Coleophora_spinella	Coleophoridae
Coleophora_infolliculella	Coleophoridae
Coleophora_epijudaica	Coleophoridae
Coleophora_unipunctella	Coleophoridae
Coleophora_salicorniae	Coleophoridae
Coleophora_clypeiferella	Coleophoridae
Coleophora_squalorella	Coleophoridae
Coleophora_hinnula	Coleophoridae
Coleophora_eupreta	Coleophoridae
Coleophora_rectilineella	Coleophoridae
Coleophora_fringillella	Coleophoridae
Coleophora_mayrella	Coleophoridae
Coleophora_serratella	Coleophoridae
Coleophora_albitarsella	Coleophoridae
Coleophora_hydrolapathella	Coleophoridae
Coleophora_samarensis	Coleophoridae
Coleophora_ornatipennella	Coleophoridae
Coleophora_lixella	Coleophoridae
Coleophora_tricolor	Coleophoridae
Coleophora_paradoxella	Coleophoridae
Coleophora_uralensis	Coleophoridae
Coleophora_bilineella	Coleophoridae
Coleophora_cyrniella	Coleophoridae
Coleophora_sergiella	Coleophoridae
Coleophora_aleramica	Coleophoridae
Coleophora_coracipennella	Coleophoridae
Coleophora_prunifoliae	Coleophoridae
Coleophora_luteolella	Coleophoridae
Coleophora_pulmonariella	Coleophoridae
Coleophora_niveicostella	Coleophoridae
Coleophora_teheranella	Coleophoridae
Coleophora_cecidophorella	Coleophoridae
Coleophora_nigridorsella	Coleophoridae
Coleophora_serinipennella	Coleophoridae
Coleophora_micronotella	Coleophoridae
Coleophora_peri	Coleophoridae
Coleophora_albicostella	Coleophoridae
Coleophora_juncicolella	Coleophoridae
Coleophora_sirella	Coleophoridae
Coleophora_variicornis	Coleophoridae
Coleophora_hieronella	Coleophoridae
Coleophora_kyffhusana	Coleophoridae
Coleophora_tremula	Coleophoridae
Coleophora_riffelensis	Coleophoridae
Coleophora_virgaureae	Coleophoridae
Coleophora_marcarolensis	Coleophoridae
Coleophora_necessaria	Coleophoridae
Coleophora_ochripennella	Coleophoridae
Coleophora_wockeella	Coleophoridae
Coleophora_murinella	Coleophoridae
Coleophora_glitzella	Coleophoridae
Coleophora_arctostaphyli	Coleophoridae
Coleophora_hackmani	Coleophoridae
Coleophora_autumnella	Coleophoridae
Coleophora_arefactella	Coleophoridae
Coleophora_versurella	Coleophoridae
Coleophora_afrosarda	Coleophoridae
Coleophora_halophilella	Coleophoridae
Coleophora_pappiferella	Coleophoridae
Coleophora_ochrea	Coleophoridae
Coleophora_helianthemella	Coleophoridae
Coleophora_hiberica	Coleophoridae
Coleophora_lineolea	Coleophoridae
Coleophora_fuscocuprella	Coleophoridae
Coleophora_coarctataephaga	Coleophoridae
Coleophora_millefolii	Coleophoridae
Coleophora_occasi	Coleophoridae
Coleophora_texanella	Coleophoridae
Coleophora_tanaceti	Coleophoridae
Coleophora_frankii	Coleophoridae
Coleophora_albilineella	Coleophoridae
Coleophora_therinella	Coleophoridae
Coleophora_bagorella	Coleophoridae
Coleophora_vestianella	Coleophoridae
Coleophora_filaginella	Coleophoridae
Coleophora_berbera	Coleophoridae
Coleophora_caespititiella	Coleophoridae
Coleophora_antennariella	Coleophoridae
Coleophora_tamesis	Coleophoridae
Coleophora_oriolella	Coleophoridae
Coleophora_obtectella	Coleophoridae
Coleophora_murciana	Coleophoridae
Coleophora_lithargyrinella	Coleophoridae
Coleophora_discordella	Coleophoridae
Coleophora_sisteronica	Coleophoridae
Coleophora_bilineatella	Coleophoridae
Coleophora_retrodentella	Coleophoridae
Coleophora_striatipennella	Coleophoridae
Coleophora_algidella	Coleophoridae
Coleophora_pseudodianthi	Coleophoridae
Coleophora_dianthi	Coleophoridae
Coleophora_eichleri	Coleophoridae
Coleophora_pseudolinosyris	Coleophoridae
Coleophora_nr._virgaureae	Coleophoridae
Coleophora_sardiniae	Coleophoridae
Coleophora_lineata	Coleophoridae
Coleophora_vulnerariae	Coleophoridae
Coleophora_rudella	Coleophoridae
Coleophora_varnella	Coleophoridae
Coleophora_dubiella	Coleophoridae
Coleophora_helichrysiella	Coleophoridae
Coleophora_idaeella	Coleophoridae
Coleophora_daglarica	Coleophoridae
Coleophora_dentiferella	Coleophoridae
Coleophora_artemisicolella	Coleophoridae
Coleophora_granulatella	Coleophoridae
Coleophora_linosyridella	Coleophoridae
Coleophora_ramosella	Coleophoridae
Coleophora_mediterranea	Coleophoridae
Coleophora_quadrifariella	Coleophoridae
Coleophora_atriplicis	Coleophoridae
Coleophora_sternipennella	Coleophoridae
Coleophora_boreella	Coleophoridae
Coleophora_linosyris	Coleophoridae
Coleophora_asteris	Coleophoridae
Coleophora_obscenella	Coleophoridae
Coleophora_squamosella	Coleophoridae
Coleophora_albicosta	Coleophoridae
Coleophora_semicinerea	Coleophoridae
Coleophora_centaureivora	Coleophoridae
Coleophora_santolinella	Coleophoridae
Coleophora_ptarmicia	Coleophoridae
Coleophora_solidaginella	Coleophoridae
Coleophora_conyzae	Coleophoridae
Coleophora_quadristraminella	Coleophoridae
Coleophora_auricella	Coleophoridae
Coleophora_paucinotella	Coleophoridae
Coleophora_kahaourella	Coleophoridae
Coleophora_vestalella	Coleophoridae
Coleophora_plumbella	Coleophoridae
Coleophora_unigenella	Coleophoridae
Coleophora_narbonensis	Coleophoridae
Coleophora_pyrenaica	Coleophoridae
Coleophora_thymi	Coleophoridae
Coleophora_albicella	Coleophoridae
Coleophora_occatella	Coleophoridae
Coleophora_amarchana	Coleophoridae
Coleophora_remizella	Coleophoridae
Coleophora_tyrrhaenica	Coleophoridae
Coleophora_adspersella	Coleophoridae
Coleophora_guadicensis	Coleophoridae
Coleophora_lycaoniae	Coleophoridae
Coleophora_saxicolella	Coleophoridae
Coleophora_adjunctella	Coleophoridae
Coleophora_lassella	Coleophoridae
Coleophora_soffneriella	Coleophoridae
Coleophora_taeniipennella	Coleophoridae
Coleophora_glaucicolella	Coleophoridae
Coleophora_alticolella	Coleophoridae
Coleophora_brunneosignata	Coleophoridae
Coleophora_supinella	Coleophoridae
Coleophora_hartigi	Coleophoridae
Coleophora_afrohispana	Coleophoridae
Coleophora_serratulella	Coleophoridae
Coleophora_brevipalpella	Coleophoridae
Coleophora_argenteonivea	Coleophoridae
Coleophora_conspicuella	Coleophoridae
Coleophora_involucrella	Coleophoridae
Coleophora_partitella	Coleophoridae
Coleophora_chamaedriella	Coleophoridae
Coleophora_mareki	Coleophoridae
Coleophora_serpylletorum	Coleophoridae
Coleophora_virgatella	Coleophoridae
Coleophora_struella	Coleophoridae
Coleophora_eupepla	Coleophoridae
Coleophora_acrisella	Coleophoridae
Coleophora_violacea	Coleophoridae
Coleophora_binderella	Coleophoridae
Coleophora_vitisella	Coleophoridae
Coleophora_obscuripalpella	Coleophoridae
Coleophora_thulea	Coleophoridae
Coleophora_amellivora	Coleophoridae
Coleophora_trochilella	Coleophoridae
Coleophora_inulae	Coleophoridae
Coleophora_adelogrammella	Coleophoridae
Coleophora_tringella	Coleophoridae
Coleophora_punctulatella	Coleophoridae
Coleophora_uniphalli	Coleophoridae
Coleophora_tanitella	Coleophoridae
Coleophora_acutiphaga	Coleophoridae
Coleophora_sylvaticella	Coleophoridae
Coleophora_otidipennella	Coleophoridae
Coleophora_vulpecula	Coleophoridae
Coleophora_potentillae	Coleophoridae
Coleophora_ahenella	Coleophoridae
Coleophora_orbitella	Coleophoridae
Coleophora_lusciniaepennella	Coleophoridae
Coleophora_ledi	Coleophoridae
Coleophora_thurneri	Coleophoridae
Coleophora_ribasella	Coleophoridae
Coleophora_gardesanella	Coleophoridae
Coleophora_albicans	Coleophoridae
Coleophora_nutantella	Coleophoridae
Coleophora_eltonica	Coleophoridae
Coleophora_lessinica	Coleophoridae
Coleophora_clarissa	Coleophoridae
Coleophora_deviella	Coleophoridae
Coleophora_silenella	Coleophoridae
Coleophora_graminicolella	Coleophoridae
Coleophora_nubivagella	Coleophoridae
Coleophora_korbi	Coleophoridae
Coleophora_burmanni	Coleophoridae
Coleophora_succursella	Coleophoridae
Coleophora_chrysanthemi	Coleophoridae
Coleophora_bazae	Coleophoridae
Coleophora_absinthii	Coleophoridae
Coleophora_peribenanderi	Coleophoridae
Coleophora_nanophyti	Coleophoridae
Coleophora_currucipennella	Coleophoridae
Coleophora_solenella	Coleophoridae
Coleophora_vibicella	Coleophoridae
Coleophora_cracella	Coleophoridae
Coleophora_ononidella	Coleophoridae
Coleophora_gazella	Coleophoridae
Coleophora_vibicigerella	Coleophoridae
Coleophora_squamella	Coleophoridae
Coleophora_colutella	Coleophoridae
Coleophora_congeriella	Coleophoridae
Coleophora_carelica	Coleophoridae
Coleophora_expressella	Coleophoridae
Coleophora_directella	Coleophoridae
Coleophora_helgada	Coleophoridae
Coleophora_aestuariella	Coleophoridae
Coleophora_cartilaginella	Coleophoridae
Coleophora_spumosella	Coleophoridae
Coleophora_bifurcella	Coleophoridae
Coleophora_caelebipennella	Coleophoridae
Coleophora_pilosae	Coleophoridae
Coleophora_genistae	Coleophoridae
Coleophora_svenssoni	Coleophoridae
Coleophora_onobrychiella	Coleophoridae
Coleophora_medelichensis	Coleophoridae
Coleophora_sibiricella	Coleophoridae
Coleophora_laricella	Coleophoridae
Coleophora_vacciniella	Coleophoridae
Coleophora_cornutella	Coleophoridae
Coleophora_argentula	Coleophoridae
Coleophora_follicularis	Coleophoridae
Coleophora_paripennella	Coleophoridae
Coleophora_kuehnella	Coleophoridae
Coleophora_pyrrhulipennella	Coleophoridae
Coleophora_pulchripennella	Coleophoridae
Coleophora_orenburgella	Coleophoridae
Coleophora_astragalella	Coleophoridae
Coleophora_tshiligella	Coleophoridae
Coleophora_changaica	Coleophoridae
Coleophora_hongorella	Coleophoridae
Coleophora_chretieni	Coleophoridae
Coleophora_ditella	Coleophoridae
Coleophora_trifariella	Coleophoridae
Coleophora_galbulipennella	Coleophoridae
Coleophora_albidella	Coleophoridae
Coleophora_bernoulliella	Coleophoridae
Coleophora_betulella	Coleophoridae
Coleophora_ibipennella	Coleophoridae
Coleophora_zelleriella	Coleophoridae
Coleophora_polonicella	Coleophoridae
Coleophora_parthenogenella	Coleophoridae
Coleophora_saturatella	Coleophoridae
Coleophora_depunctella	Coleophoridae
Coleophora_solitariella	Coleophoridae
Coleophora_valesianella	Coleophoridae
Coleophora_fuscociliella	Coleophoridae
Anatrachyntis_badia	Cosmopterigidae
Limnaecia_phragmitella	Cosmopterigidae
Pyroderces_argyrogrammos	Cosmopterigidae
Coccidiphila_danilevskyi	Cosmopterigidae
Stagmatophora_heydeniella	Cosmopterigidae
Vulcaniella_fiordalisa	Cosmopterigidae
Pancalia_schwarzella	Cosmopterigidae
Pancalia_leuwenhoekella	Cosmopterigidae
Spuleria_flavicaput	Cosmopterigidae
Cosmopterix_zieglerella	Cosmopterigidae
Cosmopterix_crassicervicella	Cosmopterigidae
Sorhagenia_janiszewskae	Cosmopterigidae
Eteobalea_albiapicella	Cosmopterigidae
Cosmopterix_pulchrimella	Cosmopterigidae
Sorhagenia_lophyrella	Cosmopterigidae
Sorhagenia_rhamniella	Cosmopterigidae
Eteobalea_tririvella	Cosmopterigidae
Cosmopterix_lienigiella	Cosmopterigidae
Cosmopterix_scribaiella	Cosmopterigidae
Eteobalea_serratella	Cosmopterigidae
Eteobalea_intermediella	Cosmopterigidae
Eteobalea_siciliae	Cosmopterigidae
Eteobalea_anonymella	Cosmopterigidae
Cosmopterix_orichalcea	Cosmopterigidae
Cosmopterix_pararufella	Cosmopterigidae
Cosmopterix_athesiae	Cosmopterigidae
Phragmataecia_castaneae	Cossidae
Acossus_terebra	Cossidae
Parahypopta_caestrum	Cossidae
Zeuzera_pyrina	Cossidae
Cossus_cossus	Cossidae
Dyspessa_psychidion	Cossidae
Dyspessa_ulula	Cossidae
Parapoynx_stratiotata	Crambidae
Duponchelia_fovealis	Crambidae
Paracorsia_repandalis	Crambidae
Cydalima_perspectalis	Crambidae
Evergestis_forficalis	Crambidae
Ecpyrrhorrhoe_diffusalis	Crambidae
Ecpyrrhorrhoe_rubiginalis	Crambidae
Nomophila_noctuella	Crambidae
Diasemiopsis_ramburialis	Crambidae
Diasemia_reticularis	Crambidae
Chilo_luteellus	Crambidae
Chilo_phragmitella	Crambidae
Metaxmeste_phrygialis	Crambidae
Orenaia_helveticalis	Crambidae
Orenaia_lugubralis	Crambidae
Paratalanta_hyalinalis	Crambidae
Paratalanta_pandalis	Crambidae
Anania_stachydalis	Crambidae
Eurrhypis_pollinalis	Crambidae
Metaxmeste_schrankiana	Crambidae
Antigastra_catalaunalis	Crambidae
Palpita_vitrealis	Crambidae
Metasia_carnealis	Crambidae
Orenaia_andereggialis	Crambidae
Orenaia_alpestralis	Crambidae
Pyrausta_despicata	Crambidae
Ostrinia_palustralis	Crambidae
Nascia_cilialis	Crambidae
Psammotis_pulveralis	Crambidae
Udea_costalis	Crambidae
Krombia_venturalis	Crambidae
Evergestis_frumentalis	Crambidae
Evergestis_aenealis	Crambidae
Uresiphita_gilvata	Crambidae
Anania_crocealis	Crambidae
Ostrinia_scapulalis	Crambidae
Ostrinia_nubilalis	Crambidae
Anania_funebris	Crambidae
Anania_verbascalis	Crambidae
Pyrausta_nigrata	Crambidae
Pyrausta_cingulata	Crambidae
Cataclysta_lemnata	Crambidae
Gesneria_centuriella	Crambidae
Mecyna_flavalis	Crambidae
Mecyna_lutealis	Crambidae
Mecyna_asinalis	Crambidae
Mecyna_trinalis	Crambidae
Evergestis_lupalis	Crambidae
Evergestis_sophialis	Crambidae
Loxostege_sticticalis	Crambidae
Loxostege_commixtalis	Crambidae
Pyrausta_castalis	Crambidae
Pyrausta_aerealis	Crambidae
Udea_elutalis	Crambidae
Udea_rhododendronalis	Crambidae
Nymphula_nitidulata	Crambidae
Euchromius_ocellea	Crambidae
Agrotera_nemoralis	Crambidae
Spoladea_recurvalis	Crambidae
Dolicharthria_punctalis	Crambidae
Scoparia_ancipitella	Crambidae
Evergestis_caesialis	Crambidae
Evergestis_dumerlei	Crambidae
Evergestis_extimalis	Crambidae
Loxostege_ephippialis	Crambidae
Loxostege_manualis	Crambidae
Acentria_ephemerella	Crambidae
Elophila_nymphaeata	Crambidae
Pediasia_luteella	Crambidae
Pediasia_truncatellus	Crambidae
Calamotropha_paludella	Crambidae
Metasia_ophialis	Crambidae
Crambus_pascuella	Crambidae
Catoptria_falsella	Crambidae
Xanthocrambus_saxonellus	Crambidae
Aporodes_floralis	Crambidae
Evergestis_pallidata	Crambidae
Evergestis_limbata	Crambidae
Sitochroa_palealis	Crambidae
Sitochroa_verticalis	Crambidae
Anania_perlucidalis	Crambidae
Anania_coronata	Crambidae
Pyrausta_falcatalis	Crambidae
Pyrausta_sanguinalis	Crambidae
Pyrausta_coracinalis	Crambidae
Udea_austriacalis	Crambidae
Udea_lutealis	Crambidae
Pediasia_pedriolellus	Crambidae
Pediasia_fascelinella	Crambidae
Pediasia_contaminella	Crambidae
Pediasia_aridella	Crambidae
Heliothela_wulfeniana	Crambidae
Chrysocrambus_craterella	Crambidae
Thisanotia_chrysonuchella	Crambidae
Eudonia_senecaensis	Crambidae
Loxostege_comptalis	Crambidae
Loxostege_aeruginalis	Crambidae
Loxostege_turbidalis	Crambidae
Loxostege_virescalis	Crambidae
Anania_fuscalis	Crambidae
Anania_terrealis	Crambidae
Anania_hortulata	Crambidae
Anania_lancealis	Crambidae
Udea_bourgognealis	Crambidae
Udea_carniolica	Crambidae
Udea_uliginosalis	Crambidae
Udea_alpinalis	Crambidae
Udea_murinalis	Crambidae
Udea_nebulalis	Crambidae
Udea_olivalis	Crambidae
Udea_accolalis	Crambidae
Udea_ferrugalis	Crambidae
Pleuroptya_balteata	Crambidae
Pleuroptya_ruralis	Crambidae
Platytes_cerussella	Crambidae
Platytes_alpinella	Crambidae
Donacaula_forficella	Crambidae
Crambus_silvella	Crambidae
Catoptria_furcatellus	Crambidae
Cynaeda_gigantea	Crambidae
Cynaeda_dentalis	Crambidae
Atralata_albofascialis	Crambidae
Titanio_tarraconensis	Crambidae
Scoparia_ambigualis	Crambidae
Scoparia_basistrigalis	Crambidae
Syrianarpia_faunieralis	Crambidae
Pyrausta_obfuscata	Crambidae
Pyrausta_aurata	Crambidae
Pyrausta_porphyralis	Crambidae
Udea_fulvalis	Crambidae
Udea_languidalis	Crambidae
Udea_cyanalis	Crambidae
Udea_hamalis	Crambidae
Udea_prunalis	Crambidae
Donacaula_mucronella	Crambidae
Schoenobius_gigantella	Crambidae
Crambus_lathoniellus	Crambidae
Crambus_uliginosellus	Crambidae
Scoparia_perplexella	Crambidae
Scoparia_subfusca	Crambidae
Eudonia_alpina	Crambidae
Pyrausta_purpuralis	Crambidae
Pyrausta_ostrinalis	Crambidae
Udea_inquinatalis	Crambidae
Udea_decrepitalis	Crambidae
Chrysoteuchia_culmella	Crambidae
Crambus_hamella	Crambidae
Crambus_monochromellus	Crambidae
Crambus_perlella	Crambidae
Crambus_alienellus	Crambidae
Crambus_ericella	Crambidae
Crambus_heringiellus	Crambidae
Crambus_pratella	Crambidae
Catoptria_petrificella	Crambidae
Catoptria_combinella	Crambidae
Catoptria_verellus	Crambidae
Catoptria_kasyi	Crambidae
Catoptria_lythargyrella	Crambidae
Scoparia_pyralella	Crambidae
Scoparia_italica	Crambidae
Scoparia_manifestella	Crambidae
Catoptria_mytilella	Crambidae
Catoptria_fulgidella	Crambidae
Catoptria_languidellus	Crambidae
Catoptria_margaritella	Crambidae
Catoptria_pinella	Crambidae
Catoptria_confusellus	Crambidae
Agriphila_geniculea	Crambidae
Scoparia_ingratella	Crambidae
Scoparia_conicella	Crambidae
Catoptria_myella	Crambidae
Catoptria_permutatellus	Crambidae
Catoptria_acutangulellus	Crambidae
Catoptria_osthelderi	Crambidae
Catoptria_permiacus	Crambidae
Catoptria_muellerrutzi	Crambidae
Agriphila_latistria	Crambidae
Agriphila_inquinatella	Crambidae
Agriphila_biarmicus	Crambidae
Agriphila_selasella	Crambidae
Agriphila_deliella	Crambidae
Eudonia_murana	Crambidae
Eudonia_pallida	Crambidae
Eudonia_mercurella	Crambidae
Eudonia_phaeoleuca	Crambidae
Eudonia_delunella	Crambidae
Catoptria_spatulellus	Crambidae
Catoptria_europaeica	Crambidae
Catoptria_pyramidellus	Crambidae
Catoptria_luctiferella	Crambidae
Catoptria_speculalis	Crambidae
Catoptria_radiella	Crambidae
Catoptria_pauperellus	Crambidae
Catoptria_conchella	Crambidae
Catoptria_bolivari	Crambidae
Catoptria_digitellus	Crambidae
Catoptria_maculalis	Crambidae
Agriphila_tristella	Crambidae
Eudonia_laetella	Crambidae
Eudonia_vallesialis	Crambidae
Eudonia_angustea	Crambidae
Eudonia_lineola	Crambidae
Agriphila_poliellus	Crambidae
Agriphila_straminella	Crambidae
Eudonia_truncicolella	Crambidae
Eudonia_lacustrata	Crambidae
Eudonia_aequalis	Crambidae
Eudonia_petrophila	Crambidae
Eudonia_sudetica	Crambidae
Anchinia_cristalis	Depressariidae
Anchinia_laureolella	Depressariidae
Anchinia_daphnella	Depressariidae
Anchinia_grisescens	Depressariidae
Hypercallia_citrinalis	Depressariidae
Depressaria_peniculatella	Depressariidae
Fuchsia_luteella	Depressariidae
Ethmia_terminella	Depressariidae
Ethmia_pusiella	Depressariidae
Telechrysis_tripuncta	Depressariidae
Heinemannia_laspeyrella	Depressariidae
Ethmia_dodecea	Depressariidae
Ethmia_quadrillella	Depressariidae
Haplochrois_ochraceella	Depressariidae
Haplochrois_buvati	Depressariidae
Ethmia_pyrausta	Depressariidae
Ethmia_bipunctella	Depressariidae
Chrysoclista_linneella	Depressariidae
Chrysoclista_lathamella	Depressariidae
Blastodacna_hellerella	Depressariidae
Blastodacna_atra	Depressariidae
Depressaria_marcella	Depressariidae
Depressaria_ululana	Depressariidae
Depressaria_chaerophylli	Depressariidae
Depressaria_ultimella	Depressariidae
Depressaria_daucella	Depressariidae
Depressaria_depressana	Depressariidae
Agonopterix_thurneri	Depressariidae
Depressaria_dictamnella	Depressariidae
Depressaria_hofmanni	Depressariidae
Depressaria_albipunctella	Depressariidae
Depressaria_badiella	Depressariidae
Depressaria_bupleurella	Depressariidae
Depressaria_radiella	Depressariidae
Depressaria_pimpinellae	Depressariidae
Depressaria_libanotidella	Depressariidae
Depressaria_heydenii	Depressariidae
Depressaria_absynthiella	Depressariidae
Depressaria_erinaceella	Depressariidae
Depressaria_tenebricosa	Depressariidae
Depressaria_krasnowodskella	Depressariidae
Agonopterix_nanatella	Depressariidae
Agonopterix_pallorella	Depressariidae
Depressaria_gallicella	Depressariidae
Depressaria_discipunctella	Depressariidae
Depressaria_artemisiae	Depressariidae
Depressaria_silesiaca	Depressariidae
Depressaria_emeritella	Depressariidae
Depressaria_pulcherrimella	Depressariidae
Depressaria_incognitella	Depressariidae
Depressaria_sordidatella	Depressariidae
Depressaria_beckmanni	Depressariidae
Depressaria_cinderella	Depressariidae
Depressaria_douglasella	Depressariidae
Depressaria_nemolella	Depressariidae
Agonopterix_fruticosella	Depressariidae
Agonopterix_mendesi	Depressariidae
Agonopterix_hypericella	Depressariidae
Luquetia_lobella	Depressariidae
Depressaria_leucocephala	Depressariidae
Depressaria_olerella	Depressariidae
Agonopterix_furvella	Depressariidae
Agonopterix_conterminella	Depressariidae
Semioscopis_steinkellneriana	Depressariidae
Agonopterix_subpropinquella	Depressariidae
Agonopterix_bipunctosa	Depressariidae
Agonopterix_senecionis	Depressariidae
Agonopterix_arctica	Depressariidae
Agonopterix_liturosa	Depressariidae
Semioscopis_strigulana	Depressariidae
Levipalpus_hepatariella	Depressariidae
Agonopterix_kaekeritziana	Depressariidae
Agonopterix_broennoeensis	Depressariidae
Semioscopis_oculella	Depressariidae
Semioscopis_avellanella	Depressariidae
Exaeretia_ciniflonella	Depressariidae
Exaeretia_preisseckeri	Depressariidae
Exaeretia_lutosella	Depressariidae
Agonopterix_alpigena	Depressariidae
Agonopterix_ciliella	Depressariidae
Agonopterix_parilella	Depressariidae
Agonopterix_selini	Depressariidae
Agonopterix_capreolella	Depressariidae
Agonopterix_ferulae	Depressariidae
Agonopterix_rutana	Depressariidae
Agonopterix_yeatiana	Depressariidae
Agonopterix_heracliana	Depressariidae
Agonopterix_angelicella	Depressariidae
Agonopterix_silerella	Depressariidae
Agonopterix_propinquella	Depressariidae
Agonopterix_hippomarathri	Depressariidae
Agonopterix_carduella	Depressariidae
Agonopterix_multiplicella	Depressariidae
Agonopterix_cluniana	Depressariidae
Exaeretia_allisella	Depressariidae
Agonopterix_quadripunctata	Depressariidae
Agonopterix_putridella	Depressariidae
Agonopterix_rotundella	Depressariidae
Agonopterix_alstromeriana	Depressariidae
Agonopterix_vendettella	Depressariidae
Agonopterix_curvipunctosa	Depressariidae
Agonopterix_purpurea	Depressariidae
Agonopterix_ocellana	Depressariidae
Agonopterix_arenella	Depressariidae
Agonopterix_laterella	Depressariidae
Agonopterix_ferocella	Depressariidae
Agonopterix_doronicella	Depressariidae
Agonopterix_chironiella	Depressariidae
Agonopterix_astrantiae	Depressariidae
Agonopterix_cnicella	Depressariidae
Agonopterix_atomella	Depressariidae
Agonopterix_thapsiella	Depressariidae
Agonopterix_adspersella	Depressariidae
Agonopterix_scopariella	Depressariidae
Agonopterix_umbellana	Depressariidae
Agonopterix_petasitis	Depressariidae
Agonopterix_assimilella	Depressariidae
Agonopterix_oinochroa	Depressariidae
Agonopterix_nervosa	Depressariidae
Ochropacha_duplaris	Drepanidae
Thyatira_batis	Drepanidae
Habrosyne_pyritoides	Drepanidae
Tetheella_fluctuosa	Drepanidae
Sabra_harpagula	Drepanidae
Falcaria_lacertinaria	Drepanidae
Cymatophorina_diluta	Drepanidae
Tethea_ocularis	Drepanidae
Tethea_or	Drepanidae
Drepana_falcataria	Drepanidae
Drepana_curvatula	Drepanidae
Asphalia_ruficollis	Drepanidae
Watsonalla_binaria	Drepanidae
Cilix_asiatica	Drepanidae
Cilix_glaucata	Drepanidae
Achlya_flavicornis	Drepanidae
Watsonalla_cultraria	Drepanidae
Watsonalla_uncinula	Drepanidae
Polyploca_ridens	Drepanidae
Polyploca_neoridens	Drepanidae
Elachista_occidentalis	Elachistinae
Elachista_juliensis	Elachistinae
Elachista_gleichenella	Elachistinae
Perittia_farinella	Elachistinae
Elachista_serricornis	Elachistinae
Elachista_tetragonella	Elachistinae
Elachista_quadripunctella	Elachistinae
Elachista_tengstromi	Elachistinae
Elachista_catalunella	Elachistinae
Elachista_berndtiella	Elachistinae
Elachista_elsaella	Elachistinae
Elachista_collitella	Elachistinae
Elachista_abiskoella	Elachistinae
Elachista_exactella	Elachistinae
Elachista_distigmatella	Elachistinae
Elachista_agelensis	Elachistinae
Elachista_subocellea	Elachistinae
Elachista_chrysodesmella	Elachistinae
Elachista_contaminatella	Elachistinae
Elachista_biatomella	Elachistinae
Perittia_herrichiella	Elachistinae
Perittia_obscurepunctella	Elachistinae
Stephensia_abbreviatella	Elachistinae
Stephensia_brunnichella	Elachistinae
Elachista_eskoi	Elachistinae
Elachista_baltica	Elachistinae
Elachista_freyerella	Elachistinae
Elachista_festucicolella	Elachistinae
Elachista_bruuni	Elachistinae
Elachista_argentella	Elachistinae
Elachista_ornithopodella	Elachistinae
Elachista_kebneella	Elachistinae
Elachista_imatrella	Elachistinae
Elachista_subalbidella	Elachistinae
Elachista_cingillella	Elachistinae
Elachista_gangabella	Elachistinae
Elachista_heringi	Elachistinae
Elachista_pollinariella	Elachistinae
Elachista_grotenfelti	Elachistinae
Elachista_nuraghella	Elachistinae
Elachista_trapeziella	Elachistinae
Elachista_adscitella	Elachistinae
Elachista_bisulcella	Elachistinae
Elachista_triatomea	Elachistinae
Elachista_lugdunensis	Elachistinae
Elachista_pullicomella	Elachistinae
Elachista_cinereopunctella	Elachistinae
Elachista_vonschantzi	Elachistinae
Elachista_exigua	Elachistinae
Elachista_squamosella	Elachistinae
Elachista_albidella	Elachistinae
Elachista_maculicerusella	Elachistinae
Elachista_elegans	Elachistinae
Elachista_deriventa	Elachistinae
Elachista_zernyi	Elachistinae
Elachista_irenae	Elachistinae
Elachista_bifasciella	Elachistinae
Elachista_alpinella	Elachistinae
Elachista_scirpi	Elachistinae
Elachista_anserinella	Elachistinae
Elachista_poae	Elachistinae
Elachista_dimicatella	Elachistinae
Elachista_herrichii	Elachistinae
Elachista_krogeri	Elachistinae
Elachista_pomerana	Elachistinae
Elachista_nielswolffi	Elachistinae
Elachista_humilis	Elachistinae
Elachista_excelsicola	Elachistinae
Elachista_utonella	Elachistinae
Elachista_baikalica	Elachistinae
Elachista_luticomella	Elachistinae
Elachista_anserinelloides	Elachistinae
Elachista_canapennella	Elachistinae
Elachista_tanaella	Elachistinae
Elachista_kilmunella	Elachistinae
Elachista_morandinii	Elachistinae
Elachista_eleochariella	Elachistinae
Elachista_subnigrella	Elachistinae
Elachista_rufocinerea	Elachistinae
Elachista_maculosella	Elachistinae
Elachista_apicipunctella	Elachistinae
Elachista_orstadii	Elachistinae
Elachista_atricomella	Elachistinae
Elachista_wieseriella	Elachistinae
Elachista_diederichsiella	Elachistinae
Elachista_lastrella	Elachistinae
Elachista_nobilella	Elachistinae
Elachista_compsa	Elachistinae
Elachista_fuscofrontella	Elachistinae
Elachista_albicapilla	Elachistinae
Elachista_albifrontella	Elachistinae
Rhoptria_dolosaria	Ennominae
Macaria_brunneata	Ennominae
Macaria_alternata	Ennominae
Lomographa_temerata	Ennominae
Macaria_notata	Ennominae
Aleucis_orientalis	Ennominae
Aleucis_distinctata	Ennominae
Narraga_nelvae	Ennominae
Macaria_carbonaria	Ennominae
Macaria_liturata	Ennominae
Macaria_signaria	Ennominae
Chariaspilates_formosaria	Ennominae
Hypomecis_roboraria	Ennominae
Aethalura_punctulata	Ennominae
Peribatodes_subflavaria	Ennominae
Peribatodes_ilicaria	Ennominae
Peribatodes_abstersaria	Ennominae
Megalycinia_strictaria	Ennominae
Pseudopanthera_macularia	Ennominae
Crocallis_boisduvaliaria	Ennominae
Lycia_pomonaria	Ennominae
Peribatodes_correptaria	Ennominae
Peribatodes_powelli	Ennominae
Selidosema_ambustaria	Ennominae
Compsoptera_jourdanaria	Ennominae
Stegania_trimaculata	Ennominae
Peribatodes_secundaria	Ennominae
Peribatodes_umbraria	Ennominae
Phyllometra_culminaria	Ennominae
Sardocyrnia_bastelicaria	Ennominae
Petrophora_binaevata	Ennominae
Ectropis_crepuscularia	Ennominae
Ekboarmia_atlanticaria	Ennominae
Agriopis_bajaria	Ennominae
Isturgia_berytaria	Ennominae
Compsoptera_opacaria	Ennominae
Afriberina_tenietaria	Ennominae
Fagivorina_arenaria	Ennominae
Plagodis_dolabraria	Ennominae
Lycia_hirtaria	Ennominae
Isturgia_arenacearia	Ennominae
Paradarisa_consonaria	Ennominae
Lycia_graecarius	Ennominae
Dyscia_lentiscaria	Ennominae
Parectropis_similaria	Ennominae
Cepphis_advenaria	Ennominae
Selidosema_pyrenaearia	Ennominae
Isturgia_tennoa	Ennominae
Epione_vespertaria	Ennominae
Stegania_cararia	Ennominae
Gnophos_furvata	Ennominae
Isturgia_messapiaria	Ennominae
Dyscia_fagaria	Ennominae
Peribatodes_perversaria	Ennominae
Hypoxystis_pluviaria	Ennominae
Theria_rupicapraria	Ennominae
Selidosema_plumaria	Ennominae
Crocallis_elinguaria	Ennominae
Selidosema_taeniolaria	Ennominae
Biston_strataria	Ennominae
Phigalia_pilosaria	Ennominae
Bupalus_piniaria	Ennominae
Biston_achyra	Ennominae
Crocallis_dardoinaria	Ennominae
Gnophos_obfuscata	Ennominae
Peribatodes_rhomboidaria	Ennominae
Isturgia_limbaria	Ennominae
Aspitates_gilvaria	Ennominae
Crocallis_albarracina	Ennominae
Itame_vincularia	Ennominae
Acanthovalva_inconspicuaria	Ennominae
Hypomecis_danieli	Ennominae
Isturgia_murinaria	Ennominae
Pachycnemia_hippocastanaria	Ennominae
Lomaspilis_marginata	Ennominae
Aspitates_ochrearia	Ennominae
Crocallis_auberti	Ennominae
Isturgia_spodiaria	Ennominae
Eumannia_lepraria	Ennominae
Dyscia_conspersaria	Ennominae
Theria_primaria	Ennominae
Selidosema_brunnearia	Ennominae
Agriopis_leucophaearia	Ennominae
Ascotis_fortunata	Ennominae
Isturgia_miniosaria	Ennominae
Crocallis_tusciaria	Ennominae
Siona_lineata	Ennominae
Crocallis_inexpectata	Ennominae
Erannis_defoliaria	Ennominae
Isturgia_roraria	Ennominae
Alsophila_aceraria	Ennominae
Calamodes_occitanaria	Ennominae
Lycia_alpina	Ennominae
Agriopis_budashkini	Ennominae
Adactylotis_contaminaria	Ennominae
Apeira_syringaria	Ennominae
Petrophora_narbonea	Ennominae
Nychiodes_waltheri	Ennominae
Zernyia_granataria	Ennominae
Dyscia_distinctaria	Ennominae
Crocallis_helenaria	Ennominae
Cleora_cinctaria	Ennominae
Isturgia_pulinda	Ennominae
Deileptenia_ribeata	Ennominae
Epirranthis_diversata	Ennominae
Eumera_regina	Ennominae
Lignyoptera_fumidaria	Ennominae
Lomaspilis_opis	Ennominae
Gnophos_perspersata	Ennominae
Tephronia_sicula	Ennominae
Ascotis_selenaria	Ennominae
Phaselia_algiricaria	Ennominae
Ecleora_solieraria	Ennominae
Dyscia_innocentaria	Ennominae
Erannis_ankeraria	Ennominae
Alcis_bastelbergeri	Ennominae
Isturgia_catalaunaria	Ennominae
Arichanna_melanaria	Ennominae
Petrophora_convergata	Ennominae
Lomographa_bimaculata	Ennominae
Lycia_lapponaria	Ennominae
Rhoptria_asperaria	Ennominae
Tephronia_cyrnea	Ennominae
Ligdia_adustata	Ennominae
Dyscia_crassipunctaria	Ennominae
Gnophos_dumetata	Ennominae
Lycia_florentina	Ennominae
Ortaliella_gruneraria	Ennominae
Alsophila_aescularia	Ennominae
Adactylotis_gesticularia	Ennominae
Apocheima_hispidaria	Ennominae
Eumannia_oppositaria	Ennominae
Plagodis_pulveraria	Ennominae
Biston_betularia	Ennominae
Cabera_pusaria	Ennominae
Tephronia_codetaria	Ennominae
Alcis_repandata	Ennominae
Tephronia_oranaria	Ennominae
Agriopis_aurantiaria	Ennominae
Tephronia_gracilaria	Ennominae
Dyscia_raunaria	Ennominae
Sardocyrnia_fortunaria	Ennominae
Dyscia_penulataria	Ennominae
Athroolopha_pennigeraria	Ennominae
Cabera_exanthemata	Ennominae
Erannis_declinans	Ennominae
Alcis_jubata	Ennominae
Eurranthis_plummistaria	Ennominae
Chemerina_caliginearia	Ennominae
Selidosema_erebaria	Ennominae
Neognopharmia_stevenaria	Ennominae
Tephronia_sepiaria	Ennominae
Nychiodes_dalmatina	Ennominae
Calamodes_subscudularia	Ennominae
Isturgia_sparsaria	Ennominae
Agriopis_marginaria	Ennominae
Cabera_leptographa	Ennominae
Crocallis_matillae	Ennominae
Synopsia_sociaria	Ennominae
Colotois_pennaria	Ennominae
Lycia_zonaria	Ennominae
Epione_repandaria	Ennominae
Macaria_fusca	Ennominae
Macaria_wauaria	Ennominae
Macaria_loricaria	Ennominae
Abraxas_grossulariata	Ennominae
Selenia_lunularia	Ennominae
Megalycinia_serraria	Ennominae
Onychora_agaritharia	Ennominae
Pachycnemia_tibiaria	Ennominae
Macaria_ichnusae	Ennominae
Macaria_artesiaria	Ennominae
Angerona_prunaria	Ennominae
Opisthograptis_luteolata	Ennominae
Chiasmia_clathrata	Ennominae
Chiasmia_aestimaria	Ennominae
Abraxas_sylvata	Ennominae
Abraxas_pantaria	Ennominae
Pungeleria_capreolaria	Ennominae
Toulgoetia_cauteriata	Ennominae
Petrophora_chlorosata	Ennominae
Campaea_honoraria	Ennominae
Ourapteryx_sambucaria	Ennominae
Selenia_tetralunaria	Ennominae
Selenia_dentaria	Ennominae
Hylaea_pinicolaria	Ennominae
Hylaea_fasciaria	Ennominae
Adalbertia_castiliaria	Ennominae
Ennomos_autumnaria	Ennominae
Ennomos_quercinaria	Ennominae
Asovia_maeoticaria	Ennominae
Campaea_margaritaria	Ennominae
Heliomata_glarearia	Ennominae
Ennomos_alniaria	Ennominae
Ennomos_erosaria	Ennominae
Ematurga_atomaria	Ennominae
Hypomecis_punctinalis	Ennominae
Odontopera_bidentata	Ennominae
Odontopera_graecarius	Ennominae
Ennomos_fuscantaria	Ennominae
Cleorodes_lichenaria	Ennominae
Perconia_strigillaria	Ennominae
Gnophos_sartata	Ennominae
Menophra_annegreteae	Ennominae
Ennomos_quercaria	Ennominae
Ennomos_duercki	Ennominae
Menophra_maderae	Ennominae
Menophra_harterti	Ennominae
Menophra_thuriferaria	Ennominae
Menophra_abruptaria	Ennominae
Charissa_mutilata	Ennominae
Charissa_mucidaria	Ennominae
Glacies_spitzi	Ennominae
Glacies_noricana	Ennominae
Sciadia_septaria	Ennominae
Psodos_quadrifaria	Ennominae
Elophos_vittaria	Ennominae
Crocota_tinctaria	Ennominae
Glacies_coracina	Ennominae
Elophos_dilucidaria	Ennominae
Glacies_baldensis	Ennominae
Glacies_canaliculata	Ennominae
Elophos_caelibaria	Ennominae
Glacies_alpinata	Ennominae
Crocota_niveata	Ennominae
Glacies_chalybaeus	Ennominae
Sciadia_tenebraria	Ennominae
Glacies_wehrlii	Ennominae
Glacies_belzebuth	Ennominae
Glacies_bentelii	Ennominae
Glacies_alticolaria	Ennominae
Crocota_peletieraria	Ennominae
Elophos_unicoloraria	Ennominae
Elophos_zirbitzensis	Ennominae
Glacies_burmanni	Ennominae
Elophos_dognini	Ennominae
Elophos_zelleraria	Ennominae
Sciadia_dolomitica	Ennominae
Elophos_andereggaria	Ennominae
Elophos_serotinaria	Ennominae
Elophos_sproengertsi	Ennominae
Crocota_pseudotinctaria	Ennominae
Sciadia_slovenica	Ennominae
Menophra_berenicidaria	Ennominae
Menophra_japygiaria	Ennominae
Charissa_canariensis	Ennominae
Nychiodes_obscuraria	Ennominae
Nychiodes_ragusaria	Ennominae
Nychiodes_notarioi	Ennominae
Charissa_variegata	Ennominae
Charissa_subtaurica	Ennominae
Charissa_corsica	Ennominae
Charissa_predotae	Ennominae
Charissa_onustaria	Ennominae
Charissa_ambiguata	Ennominae
Gnophos_urmensis	Ennominae
Nychiodes_hispanica	Ennominae
Nychiodes_atlanticaria	Ennominae
Nychiodes_torrevinagrensis	Ennominae
Charissa_assoi	Ennominae
Charissa_dubitaria	Ennominae
Charissa_glaucinaria	Ennominae
Charissa_avilarius	Ennominae
Charissa_crenulata	Ennominae
Charissa_italohelveticus	Ennominae
Charissa_pullata	Ennominae
Charissa_pfeifferi	Ennominae
Charissa_graecaria	Ennominae
Charissa_certhiatus	Ennominae
Charissa_bellieri	Ennominae
Charissa_obscurata	Ennominae
Charissa_intermedia	Ennominae
Charissa_supinaria	Ennominae
Ochromolopis_staintonellus	Epermeniidae
Ochromolopis_ictella	Epermeniidae
Epermenia_chaerophyllella	Epermeniidae
Epermenia_falciformis	Epermeniidae
Epermenia_illigerella	Epermeniidae
Epermenia_aequidentellus	Epermeniidae
Epermenia_scurella	Epermeniidae
Epermenia_pontificella	Epermeniidae
Phaulernis_fulviguttella	Epermeniidae
Epermenia_iniquellus	Epermeniidae
Phaulernis_dentella	Epermeniidae
Epermenia_pumila	Epermeniidae
Epermenia_profugella	Epermeniidae
Phaulernis_laserinella	Epermeniidae
Phaulernis_statariella	Epermeniidae
Nudaria_mundana	Erebidae
Setina_aurita	Erebidae
Setina_irrorella	Erebidae
Setina_roscida	Erebidae
Pelosia_muscerda	Erebidae
Scoliopteryx_libatrix	Erebidae
Atlantarctia_tigrina	Erebidae
Arctia_caja	Erebidae
Pelosia_obtusa	Erebidae
Euchomena_pudica	Erebidae
Parasemia_plantaginis	Erebidae
Atolmis_rubricollis	Erebidae
Callimorpha_dominula	Erebidae
Idia_calvaria	Erebidae
Herminia_tarsicrinalis	Erebidae
Diacrisia_sannio	Erebidae
Rhyparia_purpurata	Erebidae
Euplagia_quadripunctaria	Erebidae
Paracolax_tristalis	Erebidae
Grammia_quenseli	Erebidae
Arctia_villica	Erebidae
Hyphoraia_testudinaria	Erebidae
Hyphoraia_aulica	Erebidae
Lithosia_quadra	Erebidae
Cybosia_mesomella	Erebidae
Tyria_jacobaeae	Erebidae
Calyptra_thalictri	Erebidae
Colobochyla_salicalis	Erebidae
Orectis_proboscidata	Erebidae
Hypena_proboscidalis	Erebidae
Penthophera_morio	Erebidae
Nodaria_nodosalis	Erebidae
Pechipogo_plumigeralis	Erebidae
Herminia_tenuialis	Erebidae
Pericallia_matronula	Erebidae
Borearctia_menetriesi	Erebidae
Arctia_flavia	Erebidae
Eilema_griseola	Erebidae
Eilema_depressa	Erebidae
Eilema_sororcula	Erebidae
Coscinia_cribraria	Erebidae
Miltochrista_miniata	Erebidae
Thumatha_senex	Erebidae
Arctornis_lnigrum	Erebidae
Raparna_conicephala	Erebidae
Trisateles_emortualis	Erebidae
Hypena_lividalis	Erebidae
Polypogon_tentacularia	Erebidae
Herminia_tarsipennalis	Erebidae
Pechipogo_strigilata	Erebidae
Drasteria_cailino	Erebidae
Macrochilo_cribrumalis	Erebidae
Herminia_grisealis	Erebidae
Spilosoma_lubricipeda	Erebidae
Spilosoma_lutea	Erebidae
Holoarctia_puengeleri	Erebidae
Holoarctia_cervini	Erebidae
Chelis_simplonica	Erebidae
Chelis_maculosa	Erebidae
Acerbia_alpina	Erebidae
Pararctia_lapponica	Erebidae
Eilema_lurideola	Erebidae
Spiris_striata	Erebidae
Spiris_slovenica	Erebidae
Lymantria_dispar	Erebidae
Leucoma_salicis	Erebidae
Zebeeba_falsalis	Erebidae
Rivula_sericealis	Erebidae
Hypenodes_humidalis	Erebidae
Apopestes_spectrum	Erebidae
Phytometra_sanctiflorentis	Erebidae
Phytometra_viridaria	Erebidae
Hypena_obsitalis	Erebidae
Dysauxes_ancilla	Erebidae
Dysauxes_famula	Erebidae
Amata_phegea	Erebidae
Zanclognatha_lunalis	Erebidae
Zanclognatha_zelleralis	Erebidae
Grammodes_stolida	Erebidae
Euclidia_glyphica	Erebidae
Euclidia_mi	Erebidae
Zethes_insularis	Erebidae
Diaphora_sordida	Erebidae
Diaphora_mendica	Erebidae
Phragmatobia_fuliginosa	Erebidae
Calliteara_abietis	Erebidae
Calliteara_pudibunda	Erebidae
Lymantria_monacha	Erebidae
Euproctis_chrysorrhoea	Erebidae
Euproctis_similis	Erebidae
Schrankia_taenialis	Erebidae
Schrankia_costaestrigalis	Erebidae
Autophila_cataphanes	Erebidae
Lygephila_viciae	Erebidae
Lygephila_craccae	Erebidae
Lygephila_procax	Erebidae
Metachrostis_velox	Erebidae
Metachrostis_velocior	Erebidae
Laspeyria_flexula	Erebidae
Hypena_rostralis	Erebidae
Amata_ragazzii	Erebidae
Amata_kruegeri	Erebidae
Catephia_alchymista	Erebidae
Catocala_pacta	Erebidae
Spilosoma_urticae	Erebidae
Eilema_pygmaeola	Erebidae
Eilema_caniola	Erebidae
Orgyia_recens	Erebidae
Laelia_coenosa	Erebidae
Ocneria_ledereri	Erebidae
Ocneria_rubea	Erebidae
Autophila_hirsuta	Erebidae
Lygephila_pastinum	Erebidae
Lygephila_lusoria	Erebidae
Hypena_obesalis	Erebidae
Hypena_crassalis	Erebidae
Minucia_lunaris	Erebidae
Dysgonia_algira	Erebidae
Watsonarctia_deserta	Erebidae
Setema_cereola	Erebidae
Eilema_lutarella	Erebidae
Eilema_pseudocomplana	Erebidae
Eilema_complana	Erebidae
Orgyia_antiqua	Erebidae
Gynaephora_selenitica	Erebidae
Dicallomera_fascelina	Erebidae
Autophila_limbata	Erebidae
Autophila_dilucida	Erebidae
Parascotia_nisseni	Erebidae
Parascotia_fuliginaria	Erebidae
Eublemma_polygramma	Erebidae
Catocala_nymphaea	Erebidae
Catocala_fulminea	Erebidae
Catocala_nymphagoga	Erebidae
Phragmatobia_luctifera	Erebidae
Orgyia_antiquoides	Erebidae
Orgyia_trigotephras	Erebidae
Odice_jucunda	Erebidae
Ocnogyna_corsica	Erebidae
Ocnogyna_parasita	Erebidae
Eublemma_purpurina	Erebidae
Catocala_fraxini	Erebidae
Eublemma_ostrina	Erebidae
Catocala_dilecta	Erebidae
Catocala_sponsa	Erebidae
Catocala_lupina	Erebidae
Catocala_electa	Erebidae
Eublemma_rietzi	Erebidae
Catocala_promissa	Erebidae
Catocala_adultera	Erebidae
Catocala_nupta	Erebidae
Catocala_deducta	Erebidae
Catocala_elocata	Erebidae
Eublemma_minutata	Erebidae
Eublemma_cochylioides	Erebidae
Eublemma_parva	Erebidae
Eublemma_candidana	Erebidae
Eublemma_viridula	Erebidae
Eublemma_elychrysi	Erebidae
Dyseriocrania_subpurpurella	Eriocraniidae
Eriocrania_cicatricella	Eriocraniidae
Eriocrania_sangii	Eriocraniidae
Eriocrania_semipurpurella	Eriocraniidae
Heringocrania_unimaculella	Eriocraniidae
Eriocrania_salopiella	Eriocraniidae
Eriocrania_sparrmannella	Eriocraniidae
Paranarsia_joannisiella	Gelechiidae
Megacraspedus_eburnellus	Gelechiidae
Megacraspedus_cerussatellus	Gelechiidae
Megacraspedus_escalerellus	Gelechiidae
Aristotelia_brizella	Gelechiidae
Megacraspedus_imparellus	Gelechiidae
Caulastrocecis_furfurella	Gelechiidae
Monochroa_moyses	Gelechiidae
Monochroa_palustrellus	Gelechiidae
Monochroa_sepicolella	Gelechiidae
Monochroa_rumicetella	Gelechiidae
Argolamprotes_micella	Gelechiidae
Monochroa_nomadella	Gelechiidae
Monochroa_ferrea	Gelechiidae
Monochroa_simplicella	Gelechiidae
Monochroa_hornigi	Gelechiidae
Monochroa_lucidella	Gelechiidae
Monochroa_conspersella	Gelechiidae
Monochroa_tetragonella	Gelechiidae
Monochroa_servella	Gelechiidae
Monochroa_scutatella	Gelechiidae
Monochroa_tenebrella	Gelechiidae
Monochroa_cytisella	Gelechiidae
Monochroa_divisella	Gelechiidae
Eulamprotes_wilkella	Gelechiidae
Ptocheuusa_abnormella	Gelechiidae
Apodia_bifractella	Gelechiidae
Monochroa_niphognatha	Gelechiidae
Monochroa_suffusella	Gelechiidae
Monochroa_arundinetella	Gelechiidae
Megacraspedus_lanceolellus	Gelechiidae
Eulamprotes_plumbella	Gelechiidae
Eulamprotes_superbella	Gelechiidae
Ptocheuusa_inopella	Gelechiidae
Ptocheuusa_paupella	Gelechiidae
Eulamprotes_nigromaculella	Gelechiidae
Aristotelia_heliacella	Gelechiidae
Monochroa_elongella	Gelechiidae
Megacraspedus_separatellus	Gelechiidae
Megacraspedus_tristictus	Gelechiidae
Megacraspedus_dolosellus	Gelechiidae
Megacraspedus_incertellus	Gelechiidae
Eulamprotes_atrella	Gelechiidae
Eulamprotes_unicolorella	Gelechiidae
Eulamprotes_libertinella	Gelechiidae
Metzneria_paucipunctella	Gelechiidae
Gladiovalva_rumicivorella	Gelechiidae
Metzneria_artificella	Gelechiidae
Psoricoptera_gibbosella	Gelechiidae
Psoricoptera_speciosella	Gelechiidae
Gelechia_hippophaella	Gelechiidae
Aristotelia_decurtella	Gelechiidae
Monochroa_sperata	Gelechiidae
Monochroa_lutulentella	Gelechiidae
Eulamprotes_ochricapilla	Gelechiidae
Eulamprotes_occidentella	Gelechiidae
Metzneria_lappella	Gelechiidae
Metzneria_aprilella	Gelechiidae
Isophrictis_striatella	Gelechiidae
Apatetris_mediterranella	Gelechiidae
Chrysoesthia_drurella	Gelechiidae
Aristotelia_decoratella	Gelechiidae
Aristotelia_ericinella	Gelechiidae
Nothris_lemniscellus	Gelechiidae
Aponoea_obtusipalpis	Gelechiidae
Metzneria_hilarella	Gelechiidae
Metzneria_ehikeella	Gelechiidae
Metzneria_santolinella	Gelechiidae
Metzneria_riadella	Gelechiidae
Metzneria_subflavella	Gelechiidae
Isophrictis_kefersteiniellus	Gelechiidae
Isophrictis_anthemidella	Gelechiidae
Gelechia_sestertiella	Gelechiidae
Gelechia_rhombelliformis	Gelechiidae
Nothris_congressariella	Gelechiidae
Nothris_verbascella	Gelechiidae
Metzneria_metzneriella	Gelechiidae
Metzneria_tristella	Gelechiidae
Metzneria_diffusella	Gelechiidae
Metzneria_neuropterella	Gelechiidae
Metzneria_castiliella	Gelechiidae
Metzneria_aestivella	Gelechiidae
Gelechia_muscosella	Gelechiidae
Gelechia_rhombella	Gelechiidae
Gelechia_scotinella	Gelechiidae
Gelechia_turpella	Gelechiidae
Neofaculta_infernella	Gelechiidae
Neofaculta_ericetella	Gelechiidae
Anarsia_lineatella	Gelechiidae
Aroga_aristotelis	Gelechiidae
Gelechia_nigra	Gelechiidae
Gelechia_basipunctella	Gelechiidae
Gelechia_aspoecki	Gelechiidae
Gelechia_sabinellus	Gelechiidae
Pexicopia_malvella	Gelechiidae
Anarsia_burmanni	Gelechiidae
Anarsia_spartiella	Gelechiidae
Hypatima_rhomboidella	Gelechiidae
Aroga_velocella	Gelechiidae
Gelechia_asinella	Gelechiidae
Gelechia_cuneatella	Gelechiidae
Gelechia_senticetella	Gelechiidae
Sitotroga_cerealella	Gelechiidae
Platyedra_subcinerea	Gelechiidae
Stomopteryx_remissella	Gelechiidae
Chrysoesthia_sexguttella	Gelechiidae
Xystophora_pulveratella	Gelechiidae
Sophronia_gelidella	Gelechiidae
Epidola_stigma	Gelechiidae
Mirificarma_lentiginosella	Gelechiidae
Exoteleia_dodecella	Gelechiidae
Exoteleia_succinctella	Gelechiidae
Telphusa_cistiflorella	Gelechiidae
Aroga_balcanicola	Gelechiidae
Aroga_flavicomella	Gelechiidae
Mirificarma_eburnella	Gelechiidae
Athrips_amoenella	Gelechiidae
Athrips_tetrapunctella	Gelechiidae
Athrips_rancidella	Gelechiidae
Gelechia_jakovlevi	Gelechiidae
Gelechia_sororculella	Gelechiidae
Prolita_sexpunctella	Gelechiidae
Prolita_solutella	Gelechiidae
Chionodes_ignorantella	Gelechiidae
Chionodes_fumatella	Gelechiidae
Chionodes_viduella	Gelechiidae
Stomopteryx_flavipalpella	Gelechiidae
Anacampsis_obscurella	Gelechiidae
Mesophleps_trinotella	Gelechiidae
Sophronia_semicostella	Gelechiidae
Mirificarma_mulinella	Gelechiidae
Mirificarma_interrupta	Gelechiidae
Anasphaltis_renigerellus	Gelechiidae
Dichomeris_latipennella	Gelechiidae
Dichomeris_alacella	Gelechiidae
Coleotechnites_piceaella	Gelechiidae
Aroga_temporariella	Gelechiidae
Filatima_incomptella	Gelechiidae
Recurvaria_nanella	Gelechiidae
Recurvaria_leucatella	Gelechiidae
Stenolechia_gemmella	Gelechiidae
Megacraspedus_bilineatella	Gelechiidae
Mirificarma_maculatella	Gelechiidae
Mirificarma_cytisella	Gelechiidae
Scrobipalpa_suasella	Gelechiidae
Athrips_pruinosella	Gelechiidae
Athrips_mouffetella	Gelechiidae
Brachmia_blandella	Gelechiidae
Bryotropha_domestica	Gelechiidae
Anacampsis_fuscella	Gelechiidae
Mesophleps_oxycedrella	Gelechiidae
Sophronia_sicariellus	Gelechiidae
Acompsia_schmidtiellus	Gelechiidae
Dichomeris_rasilella	Gelechiidae
Ochrodia_subdiminutella	Gelechiidae
Neofriseria_peliella	Gelechiidae
Neofriseria_singula	Gelechiidae
Brachmia_inornatella	Gelechiidae
Brachmia_dimidiella	Gelechiidae
Chionodes_holosericella	Gelechiidae
Chionodes_distinctella	Gelechiidae
Syncopacma_cinctella	Gelechiidae
Mesophleps_ochraceella	Gelechiidae
Sophronia_chilonella	Gelechiidae
Sophronia_humerella	Gelechiidae
Dichomeris_lamprostoma	Gelechiidae
Dichomeris_helianthemi	Gelechiidae
Helcystogramma_arulensis	Gelechiidae
Dichomeris_derasella	Gelechiidae
Ephysteris_iberica	Gelechiidae
Palumbina_guerinii	Gelechiidae
Parastenolechia_nigrinotella	Gelechiidae
Altenia_perspersella	Gelechiidae
Pseudotelphusa_tessella	Gelechiidae
Pogochaetia_solitaria	Gelechiidae
Scrobipalpa_acuminatella	Gelechiidae
Scrobipalpa_vasconiella	Gelechiidae
Chionodes_violacea	Gelechiidae
Chionodes_continuella	Gelechiidae
Syncopacma_vinella	Gelechiidae
Syncopacma_suecicella	Gelechiidae
Anacampsis_temerella	Gelechiidae
Anacampsis_timidella	Gelechiidae
Anacampsis_scintillella	Gelechiidae
Mesophleps_silacella	Gelechiidae
Mesophleps_corsicella	Gelechiidae
Dichomeris_marginella	Gelechiidae
Dichomeris_juniperella	Gelechiidae
Helcystogramma_lutatella	Gelechiidae
Dichomeris_ustalella	Gelechiidae
Dichomeris_limosellus	Gelechiidae
Ephysteris_diminutella	Gelechiidae
Ephysteris_promptella	Gelechiidae
Thiotricha_majorella	Gelechiidae
Thiotricha_subocellea	Gelechiidae
Stenolechiodes_pseudogemmellus	Gelechiidae
Parachronistis_albiceps	Gelechiidae
Teleiodes_vulgella	Gelechiidae
Teleiodes_italica	Gelechiidae
Scrobipalpa_brahmiella	Gelechiidae
Scrobipalpa_costella	Gelechiidae
Bryotropha_politella	Gelechiidae
Bryotropha_purpurella	Gelechiidae
Bryotropha_desertella	Gelechiidae
Bryotropha_terrella	Gelechiidae
Bryotropha_boreella	Gelechiidae
Bryotropha_galbanella	Gelechiidae
Chionodes_praeclarella	Gelechiidae
Chionodes_lugubrella	Gelechiidae
Syncopacma_ochrofasciella	Gelechiidae
Syncopacma_karvoneni	Gelechiidae
Syncopacma_captivella	Gelechiidae
Syncopacma_patruella	Gelechiidae
Syncopacma_buvati	Gelechiidae
Anacampsis_blattariella	Gelechiidae
Anacampsis_populella	Gelechiidae
Acompsia_maculosella	Gelechiidae
Acompsia_delmastroella	Gelechiidae
Acompsia_dimorpha	Gelechiidae
Acompsia_antirrhinella	Gelechiidae
Acompsia_tripunctella	Gelechiidae
Acompsia_ponomarenkoae	Gelechiidae
Acompsia_pyrenaella	Gelechiidae
Acompsia_subpunctella	Gelechiidae
Acompsia_cinerella	Gelechiidae
Helcystogramma_rufescens	Gelechiidae
Helcystogramma_lineolella	Gelechiidae
Tuta_absoluta	Gelechiidae
Caryocolum_laceratella	Gelechiidae
Scrobipalpopsis_petasitis	Gelechiidae
Scrobipalpa_bigoti	Gelechiidae
Bryotropha_similis	Gelechiidae
Bryotropha_dryadella	Gelechiidae
Bryotropha_senectella	Gelechiidae
Chionodes_nebulosella	Gelechiidae
Chionodes_perpetuella	Gelechiidae
Chionodes_nubilella	Gelechiidae
Aproaerema_lerauti	Gelechiidae
Aproaerema_anthyllidella	Gelechiidae
Iwaruna_biguttella	Gelechiidae
Syncopacma_sangiella	Gelechiidae
Teleiodes_flavimaculella	Gelechiidae
Teleiodes_luculella	Gelechiidae
Gnorimoschema_epithymella	Gelechiidae
Gnorimoschema_herbichii	Gelechiidae
Caryocolum_cauligenella	Gelechiidae
Caryocolum_saginella	Gelechiidae
Klimeschiopsis_terroris	Gelechiidae
Lutilabria_lutilabrella	Gelechiidae
Scrobipalpa_feralella	Gelechiidae
Scrobipalpa_proclivella	Gelechiidae
Chionodes_luctuella	Gelechiidae
Syncopacma_larseniella	Gelechiidae
Syncopacma_wormiella	Gelechiidae
Syncopacma_taeniolella	Gelechiidae
Syncopacma_coronillella	Gelechiidae
Aristotelia_subdecurtella	Gelechiidae
Xenolechia_aethiops	Gelechiidae
Altenia_scriptella	Gelechiidae
Teleiopsis_laetitiae	Gelechiidae
Teleiopsis_paulheberti	Gelechiidae
Teleiopsis_rosalbella	Gelechiidae
Teleiopsis_albifemorella	Gelechiidae
Teleiopsis_lindae	Gelechiidae
Teleiopsis_bagriotella	Gelechiidae
Teleiopsis_diffinis	Gelechiidae
Teleiopsis_terebinthinella	Gelechiidae
Neotelphusa_sequax	Gelechiidae
Carpatolechia_decorella	Gelechiidae
Scrobipalpula_ramosella	Gelechiidae
Scrobipalpula_psilella	Gelechiidae
Scrobipalpula_tussilaginis	Gelechiidae
Scrobipalpula_diffluella	Gelechiidae
Gnorimoschema_nilsi	Gelechiidae
Gnorimoschema_streliciella	Gelechiidae
Gnorimoschema_valesiella	Gelechiidae
Gnorimoschema_nordlandicolella	Gelechiidae
Cosmardia_moritzella	Gelechiidae
Caryocolum_jaspidella	Gelechiidae
Klimeschiopsis_kiningerella	Gelechiidae
Sattleria_dzieduszyckii	Gelechiidae
Agonochaetia_terrestrella	Gelechiidae
Agonochaetia_intermedia	Gelechiidae
Scrobipalpa_wiltshirei	Gelechiidae
Scrobipalpa_halonella	Gelechiidae
Scrobipalpa_pauperella	Gelechiidae
Scrobipalpa_bradleyi	Gelechiidae
Scrobipalpa_bryophiloides	Gelechiidae
Bryotropha_plantariella	Gelechiidae
Bryotropha_basaltinella	Gelechiidae
Bryotropha_umbrosella	Gelechiidae
Bryotropha_affinis	Gelechiidae
Chionodes_tragicella	Gelechiidae
Chionodes_electella	Gelechiidae
Aristotelia_frankeniae	Gelechiidae
Carpatolechia_aenigma	Gelechiidae
Carpatolechia_epomidella	Gelechiidae
Teleiodes_saltuum	Gelechiidae
Carpatolechia_alburnella	Gelechiidae
Caryocolum_fischerella	Gelechiidae
Caryocolum_tischeriella	Gelechiidae
Caryocolum_fraternella	Gelechiidae
Caryocolum_junctella	Gelechiidae
Klimeschiopsis_discontinuella	Gelechiidae
Klimeschiopsis_maritimaealpina	Gelechiidae
Sattleria_karsholti	Gelechiidae
Sattleria_triglavica	Gelechiidae
Scrobipalpa_niveifacies	Gelechiidae
Scrobipalpa_ocellatella	Gelechiidae
Scrobipalpa_artemisiella	Gelechiidae
Scrobipalpa_stangei	Gelechiidae
Aristotelia_baltica	Gelechiidae
Microlechia_chretieni	Gelechiidae
Teleiodes_wagae	Gelechiidae
Caryocolum_leucothoracellum	Gelechiidae
Caryocolum_peregrinella	Gelechiidae
Caryocolum_delphinatella	Gelechiidae
Caryocolum_trauniella	Gelechiidae
Caryocolum_marmorea	Gelechiidae
Caryocolum_pullatella	Gelechiidae
Caryocolum_proxima	Gelechiidae
Caryocolum_blandulella	Gelechiidae
Caryocolum_kroesmanniella	Gelechiidae
Caryocolum_gallagenellum	Gelechiidae
Caryocolum_interalbicella	Gelechiidae
Sattleria_marguareisi	Gelechiidae
Sattleria_melaleucella	Gelechiidae
Sattleria_pyrenaica	Gelechiidae
Sattleria_styriaca	Gelechiidae
Sattleria_basistrigella	Gelechiidae
Sattleria_graiaeella	Gelechiidae
Sattleria_breviramus	Gelechiidae
Scrobipalpa_obsoletella	Gelechiidae
Scrobipalpa_chrysanthemella	Gelechiidae
Scrobipalpa_corleyi	Gelechiidae
Pseudotelphusa_paripunctella	Gelechiidae
Carpatolechia_proximella	Gelechiidae
Carpatolechia_notatella	Gelechiidae
Carpatolechia_fugacella	Gelechiidae
Carpatolechia_fugitivella	Gelechiidae
Caryocolum_mazeli	Gelechiidae
Caryocolum_petryi	Gelechiidae
Caryocolum_srnkai	Gelechiidae
Caryocolum_confluens	Gelechiidae
Caryocolum_klosi	Gelechiidae
Sattleria_cottiella	Gelechiidae
Sattleria_izoardi	Gelechiidae
Pseudotelphusa_occidentella	Gelechiidae
Pseudotelphusa_scalella	Gelechiidae
Caryocolum_leucomelanella	Gelechiidae
Caryocolum_schleichi	Gelechiidae
Caryocolum_vicinella	Gelechiidae
Caryocolum_albifaciella	Gelechiidae
Caryocolum_amaurella	Gelechiidae
Caryocolum_siculum	Gelechiidae
Caryocolum_repentis	Gelechiidae
Caryocolum_huebneri	Gelechiidae
Caryocolum_petrophila	Gelechiidae
Caryocolum_cassella	Gelechiidae
Caryocolum_tricolorella	Gelechiidae
Caryocolum_fibigerium	Gelechiidae
Scrobipalpa_samadensis	Gelechiidae
Caryocolum_mucronatella	Gelechiidae
Caryocolum_blandelloides	Gelechiidae
Caryocolum_blandella	Gelechiidae
Scrobipalpa_adaptata	Gelechiidae
Scrobipalpa_murinella	Gelechiidae
Scrobipalpa_nitentella	Gelechiidae
Caryocolum_oculatella	Gelechiidae
Scrobipalpa_clintoni	Gelechiidae
Scrobipalpa_atriplicella	Gelechiidae
Scrobipalpa_salicorniae	Gelechiidae
Scrobipalpa_salinella	Gelechiidae
Scrobipalpa_stabilis	Gelechiidae
Scrobipalpa_instabilella	Gelechiidae
Caryocolum_viscariella	Gelechiidae
Caryocolum_alsinella	Gelechiidae
Aplasta_ononaria	Geometrinae
Eucrostes_indigenata	Geometrinae
Geometra_papilionaria	Geometrinae
Hemistola_chrysoprasaria	Geometrinae
Hemistola_siciliana	Geometrinae
Pseudoterpna_corsicaria	Geometrinae
Pseudoterpna_pruinata	Geometrinae
Pseudoterpna_coronillaria	Geometrinae
Microloxia_simonyi	Geometrinae
Microloxia_herbaria	Geometrinae
Xenochlorodes_olympiaria	Geometrinae
Xenochlorodes_nubigena	Geometrinae
Thalera_fimbrialis	Geometrinae
Jodis_lactearia	Geometrinae
Jodis_putata	Geometrinae
Chlorissa_viridata	Geometrinae
Chlorissa_cloraria	Geometrinae
Phaiogramma_etruscaria	Geometrinae
Phaiogramma_faustinata	Geometrinae
Kuchleria_insignata	Geometrinae
Hemithea_aestivaria	Geometrinae
Thetidia_smaragdaria	Geometrinae
Thetidia_sardinica	Geometrinae
Proteuchloris_neriaria	Geometrinae
Comibaena_bajularia	Geometrinae
Orthotelia_sparganella	Glyphipterigidae
Glyphipterix_thrasonella	Glyphipterigidae
Glyphipterix_forsterella	Glyphipterigidae
Glyphipterix_haworthana	Glyphipterigidae
Glyphipterix_fuscoviridella	Glyphipterigidae
Glyphipterix_gianelliella	Glyphipterigidae
Glyphipterix_equitella	Glyphipterigidae
Glyphipterix_schoenicolella	Glyphipterigidae
Glyphipterix_simpliciella	Glyphipterigidae
Glyphipterix_argyroguttella	Glyphipterigidae
Glyphipterix_bergstraesserella	Glyphipterigidae
Metriochroa_latifoliella	Gracillariidae
Phyllocnistis_valentinensis	Gracillariidae
Ornixola_caudulatella	Gracillariidae
Parectopa_ononidis	Gracillariidae
Phyllocnistis_citrella	Gracillariidae
Phyllocnistis_ramulicola	Gracillariidae
Phyllocnistis_saligna	Gracillariidae
Parectopa_robiniella	Gracillariidae
Phyllocnistis_unipunctella	Gracillariidae
Micrurapteryx_gradatella	Gracillariidae
Micrurapteryx_kollariella	Gracillariidae
Phyllocnistis_vitegenella	Gracillariidae
Phyllonorycter_helianthemella	Gracillariidae
Parornix_mixta	Gracillariidae
Phyllocnistis_extrematrix	Gracillariidae
Macrosaccus_robiniella	Gracillariidae
Parornix_ampliatella	Gracillariidae
Parornix_torquillella	Gracillariidae
Parornix_petiolella	Gracillariidae
Parornix_anguliferella	Gracillariidae
Phyllocnistis_xenia	Gracillariidae
Phyllocnistis_labyrinthella	Gracillariidae
Euspilapteryx_auroguttella	Gracillariidae
Calybites_phasianipennella	Gracillariidae
Calybites_quadrisignella	Gracillariidae
Parornix_acuta	Gracillariidae
Callisto_denticulella	Gracillariidae
Phyllonorycter_populifoliella	Gracillariidae
Aspilapteryx_multipunctella	Gracillariidae
Caloptilia_cuculipennella	Gracillariidae
Acrocercops_cocciferellum	Gracillariidae
Acrocercops_tacita	Gracillariidae
Acrocercops_brongniardella	Gracillariidae
Callisto_insperatella	Gracillariidae
Callisto_coffeella	Gracillariidae
Cameraria_ohridella	Gracillariidae
Phyllonorycter_schreberella	Gracillariidae
Aspilapteryx_inquinata	Gracillariidae
Aspilapteryx_limosella	Gracillariidae
Aspilapteryx_spectabilis	Gracillariidae
Aspilapteryx_tringipennella	Gracillariidae
Cupedia_cupediella	Gracillariidae
Aristaea_pavoniella	Gracillariidae
Gracillaria_loriolella	Gracillariidae
Gracillaria_syringella	Gracillariidae
Leucospilapteryx_omissella	Gracillariidae
Parornix_loganella	Gracillariidae
Parornix_betulae	Gracillariidae
Phyllonorycter_rebimbasi	Gracillariidae
Phyllonorycter_apparella	Gracillariidae
Phyllonorycter_pastorella	Gracillariidae
Phyllonorycter_comparella	Gracillariidae
Caloptilia_nobilella	Gracillariidae
Caloptilia_suberinella	Gracillariidae
Dialectica_scalariella	Gracillariidae
Parornix_fagivora	Gracillariidae
Parornix_devoniella	Gracillariidae
Parornix_finitimella	Gracillariidae
Phyllonorycter_delitella	Gracillariidae
Phyllonorycter_harrisella	Gracillariidae
Phyllonorycter_chiclanella	Gracillariidae
Phyllonorycter_sagitella	Gracillariidae
Caloptilia_aurantiaca	Gracillariidae
Caloptilia_roscipennella	Gracillariidae
Caloptilia_populetorum	Gracillariidae
Dialectica_imperialella	Gracillariidae
Parornix_scoticella	Gracillariidae
Phyllonorycter_tristrigella	Gracillariidae
Phyllonorycter_connexella	Gracillariidae
Phyllonorycter_quinqueguttella	Gracillariidae
Phyllonorycter_trifasciella	Gracillariidae
Povolnya_leucapennella	Gracillariidae
Spulerina_simploniella	Gracillariidae
Dialectica_hedemanni	Gracillariidae
Phyllonorycter_agilella	Gracillariidae
Phyllonorycter_emberizaepenella	Gracillariidae
Phyllonorycter_issikii	Gracillariidae
Phyllonorycter_scabiosella	Gracillariidae
Phyllonorycter_cephalariae	Gracillariidae
Caloptilia_stigmatella	Gracillariidae
Parornix_anglicella	Gracillariidae
Parornix_tenella	Gracillariidae
Phyllonorycter_suberifoliella	Gracillariidae
Caloptilia_coruscans	Gracillariidae
Parornix_carpinella	Gracillariidae
Parornix_traugotti	Gracillariidae
Parornix_polygrammella	Gracillariidae
Phyllonorycter_lantanella	Gracillariidae
Phyllonorycter_macedonica	Gracillariidae
Phyllonorycter_fiumella	Gracillariidae
Phyllonorycter_myricae	Gracillariidae
Phyllonorycter_junoniella	Gracillariidae
Phyllonorycter_mespilella	Gracillariidae
Parornix_szocsi	Gracillariidae
Parornix_atripalpella	Gracillariidae
Phyllonorycter_gerasimowi	Gracillariidae
Phyllonorycter_hostis	Gracillariidae
Phyllonorycter_anceps	Gracillariidae
Phyllonorycter_deschkai	Gracillariidae
Phyllonorycter_oxyacanthae	Gracillariidae
Phyllonorycter_pyrifoliella	Gracillariidae
Phyllonorycter_cydoniella	Gracillariidae
Phyllonorycter_blancardella	Gracillariidae
Phyllonorycter_sorbi	Gracillariidae
Caloptilia_hemidactylella	Gracillariidae
Phyllonorycter_leucographella	Gracillariidae
Phyllonorycter_corylifoliella	Gracillariidae
Phyllonorycter_tenerella	Gracillariidae
Phyllonorycter_klemannella	Gracillariidae
Phyllonorycter_geniculella	Gracillariidae
Phyllonorycter_acerifoliella	Gracillariidae
Phyllonorycter_joannisi	Gracillariidae
Phyllonorycter_ochreojunctella	Gracillariidae
Caloptilia_fidella	Gracillariidae
Caloptilia_falconipennella	Gracillariidae
Phyllonorycter_endryella	Gracillariidae
Phyllonorycter_anderidae	Gracillariidae
Phyllonorycter_vueltas	Gracillariidae
Caloptilia_honoratella	Gracillariidae
Caloptilia_magnifica	Gracillariidae
Caloptilia_fribergensis	Gracillariidae
Caloptilia_azaleella	Gracillariidae
Caloptilia_betulicola	Gracillariidae
Caloptilia_elongella	Gracillariidae
Phyllonorycter_olympica	Gracillariidae
Phyllonorycter_lautella	Gracillariidae
Phyllonorycter_kuhlweiniella	Gracillariidae
Phyllonorycter_aemula	Gracillariidae
Phyllonorycter_genistella	Gracillariidae
Phyllonorycter_phyllocytisi	Gracillariidae
Phyllonorycter_eugregori	Gracillariidae
Caloptilia_jurateae	Gracillariidae
Caloptilia_semifascia	Gracillariidae
Caloptilia_rufipennella	Gracillariidae
Phyllonorycter_scitulella	Gracillariidae
Phyllonorycter_nivalis	Gracillariidae
Phyllonorycter_kusdasi	Gracillariidae
Phyllonorycter_monspessulanella	Gracillariidae
Phyllonorycter_maestingella	Gracillariidae
Phyllonorycter_coryli	Gracillariidae
Phyllonorycter_esperella	Gracillariidae
Phyllonorycter_millierella	Gracillariidae
Phyllonorycter_strigulatella	Gracillariidae
Phyllonorycter_andalusicus	Gracillariidae
Phyllonorycter_hesperiella	Gracillariidae
Phyllonorycter_lapadiella	Gracillariidae
Calybites_hauderi	Gracillariidae
Phyllonorycter_parisiella	Gracillariidae
Phyllonorycter_spinicolella	Gracillariidae
Phyllonorycter_cerasicolella	Gracillariidae
Phyllonorycter_belotella	Gracillariidae
Phyllonorycter_cocciferella	Gracillariidae
Phyllonorycter_barbarella	Gracillariidae
Phyllonorycter_ulicicolella	Gracillariidae
Phyllonorycter_staintoniella	Gracillariidae
Caloptilia_robustella	Gracillariidae
Caloptilia_alchimiella	Gracillariidae
Phyllonorycter_quercifoliella	Gracillariidae
Phyllonorycter_sublautella	Gracillariidae
Phyllonorycter_muelleriella	Gracillariidae
Phyllonorycter_klimeschiella	Gracillariidae
Phyllonorycter_messaniella	Gracillariidae
Phyllonorycter_heegeriella	Gracillariidae
Phyllonorycter_platani	Gracillariidae
Phyllonorycter_mannii	Gracillariidae
Phyllonorycter_distentella	Gracillariidae
Phyllonorycter_abrasella	Gracillariidae
Phyllonorycter_roboris	Gracillariidae
Phyllonorycter_cavella	Gracillariidae
Phyllonorycter_baetica	Gracillariidae
Phyllonorycter_fraxinella	Gracillariidae
Phyllonorycter_ilicifoliella	Gracillariidae
Phyllonorycter_trojana	Gracillariidae
Phyllonorycter_alnivorella	Gracillariidae
Phyllonorycter_ulmifoliella	Gracillariidae
Phyllonorycter_stettinensis	Gracillariidae
Phyllonorycter_nicellii	Gracillariidae
Phyllonorycter_froelichiella	Gracillariidae
Phyllonorycter_etnensis	Gracillariidae
Phyllonorycter_adenocarpi	Gracillariidae
Phyllonorycter_argyrolobiella	Gracillariidae
Phyllonorycter_parvifoliella	Gracillariidae
Phyllonorycter_triflorella	Gracillariidae
Phyllonorycter_cytisifoliae	Gracillariidae
Phyllonorycter_vulturella	Gracillariidae
Phyllonorycter_pumila	Gracillariidae
Phyllonorycter_echinosparti	Gracillariidae
Phyllonorycter_viminetorum	Gracillariidae
Phyllonorycter_rolandi	Gracillariidae
Phyllonorycter_foliolosi	Gracillariidae
Phyllonorycter_juncei_madeirae	Gracillariidae
Phyllonorycter_nigrescentella	Gracillariidae
Phyllonorycter_trifoliella	Gracillariidae
Phyllonorycter_insignitella	Gracillariidae
Phyllonorycter_medicaginella	Gracillariidae
Phyllonorycter_nevadensis	Gracillariidae
Phyllonorycter_suaveolentis	Gracillariidae
Phyllonorycter_dubitella	Gracillariidae
Phyllonorycter_brevilineatella	Gracillariidae
Phyllonorycter_salicicolella	Gracillariidae
Phyllonorycter_telinella	Gracillariidae
Phyllonorycter_scopariella	Gracillariidae
Phyllonorycter_purgantella	Gracillariidae
Phyllonorycter_alpina	Gracillariidae
Phyllonorycter_rajella	Gracillariidae
Phyllonorycter_salictella	Gracillariidae
Phyllonorycter_hilarella	Gracillariidae
Phyllonorycter_tridentatae	Gracillariidae
Phyllonorycter_cerasinella	Gracillariidae
Phyllonorycter_floridae	Gracillariidae
Phyllonorycter_baldensis	Gracillariidae
Phyllonorycter_deschkanus	Gracillariidae
Phyllonorycter_haasi	Gracillariidae
Phyllonorycter_estrela	Gracillariidae
Heliozela_sericiella	Heliozelidae
Heliozela_hammoniella	Heliozelidae
Heliozela_resplendella	Heliozelidae
Holocacista_rivillei	Heliozelidae
Antispila_treitschkiella	Heliozelidae
Antispila_petryi	Heliozelidae
Antispilina_ludwigi	Heliozelidae
Antispila_oinophylla	Heliozelidae
Gazoryctra_fuscoargenteus	Hepialidae
Gazoryctra_ganna	Hepialidae
Pharmacis_lupulina	Hepialidae
Pharmacis_fusconebulosa	Hepialidae
Pharmacis_claudiae	Hepialidae
Hepialus_humuli	Hepialidae
Pharmacis_carna	Hepialidae
Phymatopus_hecta	Hepialidae
Pharmacis_anselminae	Hepialidae
Pharmacis_bertrandi	Hepialidae
Triodia_adriaticus	Hepialidae
Triodia_sylvina	Hepialidae
Carcharodus_alceae	Hesperiidae
Spialia_sertorius	Hesperiidae
Spialia_orbifer	Hesperiidae
Erynnis_tages	Hesperiidae
Heteropterus_morpheus	Hesperiidae
Muschampia_tessellum	Hesperiidae
Muschampia_cribrellum	Hesperiidae
Carcharodus_lavatherae	Hesperiidae
Pyrgus_malvoides	Hesperiidae
Pyrgus_malvae	Hesperiidae
Carterocephalus_palaemon	Hesperiidae
Carterocephalus_silvicola	Hesperiidae
Carcharodus_orientalis	Hesperiidae
Carcharodus_floccifera	Hesperiidae
Pyrgus_warrenensis	Hesperiidae
Pyrgus_armoricanus	Hesperiidae
Pyrgus_alveus	Hesperiidae
Pyrgus_onopordi	Hesperiidae
Pyrgus_cirsii	Hesperiidae
Pyrgus_serratulae	Hesperiidae
Hesperia_comma	Hesperiidae
Ochlodes_sylvanus	Hesperiidae
Gegenes_nostrodamus	Hesperiidae
Pyrgus_carthami	Hesperiidae
Pyrgus_sidae	Hesperiidae
Pyrgus_andromedae	Hesperiidae
Thymelicus_acteon	Hesperiidae
Pyrgus_cacaliae	Hesperiidae
Pyrgus_centaureae	Hesperiidae
Thymelicus_sylvestris	Hesperiidae
Thymelicus_lineola	Hesperiidae
Alloclemensia_mesospilella	Incurvariidae
Phylloporia_bistrigella	Incurvariidae
Incurvaria_praelatella	Incurvariidae
Incurvaria_masculella	Incurvariidae
Incurvaria_koerneriella	Incurvariidae
Incurvaria_pectinea	Incurvariidae
Incurvaria_circulella	Incurvariidae
Incurvaria_oehlmanniella	Incurvariidae
Incurvaria_triglavensis	Incurvariidae
Incurvaria_vetulella	Incurvariidae
Incurvaria_ploessli	Incurvariidae
Xanthorhoe_abrasaria	Larentiinae
Scotopteryx_peribolata	Larentiinae
Scotopteryx_proximaria	Larentiinae
Scotopteryx_coarctaria	Larentiinae
Xanthorhoe_designata	Larentiinae
Scotopteryx_chenopodiata	Larentiinae
Scotopteryx_ignorata	Larentiinae
Scotopteryx_alfacaria	Larentiinae
Xanthorhoe_rupicola	Larentiinae
Scotopteryx_bipunctaria	Larentiinae
Scotopteryx_luridata	Larentiinae
Scotopteryx_mucronata	Larentiinae
Scotopteryx_coelinaria	Larentiinae
Xanthorhoe_fluctuata	Larentiinae
Xanthorhoe_disjunctaria	Larentiinae
Xanthorhoe_biriviata	Larentiinae
Scotopteryx_octodurensis	Larentiinae
Scotopteryx_olympia	Larentiinae
Scotopteryx_angularia	Larentiinae
Hospitalia_flavolineata	Larentiinae
Psychophora_sabini	Larentiinae
Camptogramma_scripturata	Larentiinae
Xanthorhoe_montanata	Larentiinae
Xanthorhoe_decoloraria	Larentiinae
Orthonama_obstipata	Larentiinae
Orthonama_vittata	Larentiinae
Xanthorhoe_skoui	Larentiinae
Scotopteryx_moeniata	Larentiinae
Scotopteryx_obvallaria	Larentiinae
Xanthorhoe_ferrugata	Larentiinae
Xanthorhoe_majorata	Larentiinae
Xanthorhoe_quadrifasiata	Larentiinae
Xanthorhoe_friedrichi	Larentiinae
Xanthorhoe_oxybiata	Larentiinae
Catarhoe_cuculata	Larentiinae
Xanthorhoe_spadicearia	Larentiinae
Xanthorhoe_vidanoi	Larentiinae
Xanthorhoe_incursata	Larentiinae
Xanthorhoe_uralensis	Larentiinae
Xanthorhoe_pseudoannotinata	Larentiinae
Xanthorhoe_annotinata	Larentiinae
Camptogramma_bilineata	Larentiinae
Camptogramma_grisescens	Larentiinae
Camptogramma_bistrigata	Larentiinae
Protorhoe_unicata	Larentiinae
Protorhoe_corollaria	Larentiinae
Catarhoe_permixtaria	Larentiinae
Spargania_luctuata	Larentiinae
Catarhoe_mazeli	Larentiinae
Catarhoe_putridaria	Larentiinae
Minoa_murinata	Larentiinae
Malacodea_regelaria	Larentiinae
Catarhoe_rubidata	Larentiinae
Epilobophora_sabinata	Larentiinae
Oulobophora_internata	Larentiinae
Oulobophora_externaria	Larentiinae
Larentia_clavaria	Larentiinae
Larentia_malvata	Larentiinae
Mesoleuca_albicillata	Larentiinae
Baptria_tibiale	Larentiinae
Euphyia_unangulata	Larentiinae
Catarhoe_basochesiata	Larentiinae
Catarhoe_hortulanaria	Larentiinae
Lythria_purpuraria	Larentiinae
Lythria_plumularia	Larentiinae
Lythria_sanguinaria	Larentiinae
Lythria_cruentaria	Larentiinae
Martania_taeniata	Larentiinae
Epirrhoe_tristata	Larentiinae
Epirrhoe_sandosaria	Larentiinae
Nothocasis_sertata	Larentiinae
Entephria_caesiata	Larentiinae
Anticlea_derivata	Larentiinae
Pelurga_comitata	Larentiinae
Pterapherapteryx_sexalata	Larentiinae
Lobophora_halterata	Larentiinae
Pareulype_berberata	Larentiinae
Pareulype_lasithiotica	Larentiinae
Pareulype_casearia	Larentiinae
Electrophaes_corylata	Larentiinae
Costaconvexa_centrostrigaria	Larentiinae
Costaconvexa_polygrammata	Larentiinae
Melanthia_procellata	Larentiinae
Trichopteryx_polycommata	Larentiinae
Trichopteryx_carpinata	Larentiinae
Almeria_kalischata	Larentiinae
Eupithecia_analoga	Larentiinae
Eupithecia_abietaria	Larentiinae
Pasiphila_chloerata	Larentiinae
Mattia_callidaria	Larentiinae
Antilurga_alhambrata	Larentiinae
Gandaritis_pyraliata	Larentiinae
Euphyia_adumbraria	Larentiinae
Euphyia_mesembrina	Larentiinae
Euphyia_frustata	Larentiinae
Hydria_undulata	Larentiinae
Polythrena_coloraria	Larentiinae
Earophila_badiata	Larentiinae
Anticollix_sparsata	Larentiinae
Epirrhoe_timozzaria	Larentiinae
Epirrhoe_galiata	Larentiinae
Entephria_cyanata	Larentiinae
Entephria_infidaria	Larentiinae
Perizoma_incultaria	Larentiinae
Solitanea_mariae	Larentiinae
Phibalapteryx_virgata	Larentiinae
Colostygia_pectinataria	Larentiinae
Pasiphila_debiliata	Larentiinae
Pasiphila_rectangulata	Larentiinae
Eulithis_mellinata	Larentiinae
Euphyia_biangulata	Larentiinae
Euphyia_vallantinaria	Larentiinae
Triphosa_sabaudiata	Larentiinae
Philereme_vetulata	Larentiinae
Philereme_transversata	Larentiinae
Pennithera_firmata	Larentiinae
Pennithera_ulicata	Larentiinae
Heterothera_serraria	Larentiinae
Dysstroma_citrata	Larentiinae
Cidaria_fulvata	Larentiinae
Operophtera_fagata	Larentiinae
Operophtera_brumata	Larentiinae
Epirrhoe_pupillata	Larentiinae
Epirrhoe_alternata	Larentiinae
Entephria_flavicinctata	Larentiinae
Entephria_contestata	Larentiinae
Perizoma_flavofasciata	Larentiinae
Eustroma_reticulata	Larentiinae
Aplocera_simpliciata	Larentiinae
Cataclysme_dissimilata	Larentiinae
Odezia_atrata	Larentiinae
Chesias_legatella	Larentiinae
Chesias_capriata	Larentiinae
Chesias_angeri	Larentiinae
Nebula_ibericata	Larentiinae
Gagitodes_sagittata	Larentiinae
Eupithecia_tripunctaria	Larentiinae
Eulithis_testata	Larentiinae
Rheumaptera_hastata	Larentiinae
Rheumaptera_subhastata	Larentiinae
Hydria_montivagata	Larentiinae
Triphosa_tauteli	Larentiinae
Triphosa_dubitata	Larentiinae
Thera_cognata	Larentiinae
Dysstroma_truncata	Larentiinae
Dysstroma_latefasciata	Larentiinae
Dysstroma_infuscata	Larentiinae
Plemyria_rubiginata	Larentiinae
Epirrhoe_hastulata	Larentiinae
Epirrhoe_molluginata	Larentiinae
Epirrhoe_tartuensis	Larentiinae
Epirrhoe_rivata	Larentiinae
Entephria_polata	Larentiinae
Entephria_punctipes	Larentiinae
Entephria_flavata	Larentiinae
Entephria_nobiliaria	Larentiinae
Mesotype_parallelolineata	Larentiinae
Mesotype_verberata	Larentiinae
Mesotype_didymata	Larentiinae
Perizoma_lugdunaria	Larentiinae
Episauris_kiliani	Larentiinae
Chloroclystis_vata	Larentiinae
Gymnoscelis_rufifasciata	Larentiinae
Hydriomena_furcata	Larentiinae
Scotopteryx_burgaria	Larentiinae
Scotopteryx_vicinaria	Larentiinae
Melanthia_alaudaria	Larentiinae
Hydrelia_sylvata	Larentiinae
Euchoeca_nebulata	Larentiinae
Hydrelia_flammeolaria	Larentiinae
Cataclysme_uniformata	Larentiinae
Cataclysme_riguata	Larentiinae
Schistostege_nubilaria	Larentiinae
Schistostege_decussata	Larentiinae
Lithostege_farinata	Larentiinae
Lithostege_infuscata	Larentiinae
Lithostege_castiliaria	Larentiinae
Chesias_linogrisearia	Larentiinae
Nebula_senectaria	Larentiinae
Celonoptera_mirificaria	Larentiinae
Colostygia_aptata	Larentiinae
Eulithis_pyropata	Larentiinae
Hydria_cervinalis	Larentiinae
Hydria_gudarica	Larentiinae
Thera_juniperata	Larentiinae
Chloroclysta_miata	Larentiinae
Chloroclysta_siterata	Larentiinae
Perizoma_alchemillata	Larentiinae
Perizoma_hydrata	Larentiinae
Perizoma_affinitata	Larentiinae
Acasis_viretata	Larentiinae
Acasis_appensata	Larentiinae
Hydriomena_impluviata	Larentiinae
Hydriomena_ruberata	Larentiinae
Ecliptopera_silaceata	Larentiinae
Ecliptopera_capitata	Larentiinae
Epirrita_filigrammaria	Larentiinae
Epirrita_autumnata	Larentiinae
Epirrita_christyi	Larentiinae
Coenocalpe_lapidata	Larentiinae
Coenocalpe_millierata	Larentiinae
Lampropteryx_suffumata	Larentiinae
Lampropteryx_otregiata	Larentiinae
Aplocera_bohatschi	Larentiinae
Aplocera_praeformata	Larentiinae
Lithostege_coassata	Larentiinae
Chesias_isabella	Larentiinae
Chesias_rufata	Larentiinae
Colostygia_sericeata	Larentiinae
Colostygia_multistrigaria	Larentiinae
Cosmorhoe_ocellata	Larentiinae
Nebula_schneideraria	Larentiinae
Coenotephria_schneideraria	Larentiinae
Horisme_aemulata	Larentiinae
Horisme_corticata	Larentiinae
Eupithecia_plumbeolata	Larentiinae
Eupithecia_alliaria	Larentiinae
Eupithecia_denotata	Larentiinae
Eupithecia_virgaureata	Larentiinae
Eupithecia_ultimaria	Larentiinae
Eupithecia_gemellata	Larentiinae
Eupithecia_pantellata	Larentiinae
Eupithecia_innotata	Larentiinae
Eupithecia_nachadira	Larentiinae
Eupithecia_graphata	Larentiinae
Eupithecia_goossensiata	Larentiinae
Eupithecia_variostrigata	Larentiinae
Eupithecia_haworthiata	Larentiinae
Eupithecia_reisserata	Larentiinae
Eupithecia_oxycedrata	Larentiinae
Eupithecia_cauchiata	Larentiinae
Eupithecia_extraversaria	Larentiinae
Eupithecia_icterata	Larentiinae
Eupithecia_gratiosata	Larentiinae
Eupithecia_ogilviata	Larentiinae
Eupithecia_groenblomi	Larentiinae
Eupithecia_lentiscata	Larentiinae
Eupithecia_egenaria	Larentiinae
Eupithecia_ericeata	Larentiinae
Eupithecia_expallidata	Larentiinae
Eupithecia_silenata	Larentiinae
Eupithecia_undata	Larentiinae
Eupithecia_immundata	Larentiinae
Eupithecia_pyreneata	Larentiinae
Eupithecia_actaeata	Larentiinae
Eupithecia_veratraria	Larentiinae
Eupithecia_vulgata	Larentiinae
Eupithecia_carpophagata	Larentiinae
Eupithecia_limbata	Larentiinae
Eupithecia_riparia	Larentiinae
Eupithecia_cretaceata	Larentiinae
Eupithecia_selinata	Larentiinae
Eupithecia_pernotata	Larentiinae
Eupithecia_distinctaria	Larentiinae
Eupithecia_nanata	Larentiinae
Eupithecia_orphnata	Larentiinae
Eupithecia_millefoliata	Larentiinae
Eupithecia_druentiata	Larentiinae
Eupithecia_silenicolata	Larentiinae
Eupithecia_gueneata	Larentiinae
Eupithecia_fennoscandica	Larentiinae
Eupithecia_irriguata	Larentiinae
Eupithecia_ochridata	Larentiinae
Eupithecia_fuscicostata	Larentiinae
Eupithecia_simpliciata	Larentiinae
Eupithecia_pauxillaria	Larentiinae
Eupithecia_lanceata	Larentiinae
Eupithecia_scalptata	Larentiinae
Eupithecia_pulchellata	Larentiinae
Eupithecia_schiefereri	Larentiinae
Eupithecia_indigata	Larentiinae
Eupithecia_poecilata	Larentiinae
Eupithecia_gelidata	Larentiinae
Eupithecia_insigniata	Larentiinae
Eupithecia_spissilineata	Larentiinae
Eupithecia_satyrata	Larentiinae
Eupithecia_dodoneata	Larentiinae
Eupithecia_pimpinellata	Larentiinae
Eupithecia_intricata	Larentiinae
Eupithecia_succenturiata	Larentiinae
Eupithecia_spadiceata	Larentiinae
Eupithecia_pygmaeata	Larentiinae
Eupithecia_breviculata	Larentiinae
Eupithecia_venosata	Larentiinae
Eupithecia_conterminata	Larentiinae
Eupithecia_unedonata	Larentiinae
Eupithecia_lariciata	Larentiinae
Eupithecia_centaureata	Larentiinae
Eupithecia_trisignaria	Larentiinae
Eupithecia_sinuosaria	Larentiinae
Eupithecia_assimilata	Larentiinae
Eupithecia_impurata	Larentiinae
Eupithecia_abbreviata	Larentiinae
Eupithecia_absinthiata	Larentiinae
Eupithecia_unitaria	Larentiinae
Eupithecia_pusillata	Larentiinae
Eupithecia_phoeniceata	Larentiinae
Eupithecia_valerianata	Larentiinae
Eupithecia_extremata	Larentiinae
Eupithecia_laquaearia	Larentiinae
Eupithecia_subumbrata	Larentiinae
Eupithecia_massiliata	Larentiinae
Eupithecia_linariata	Larentiinae
Eupithecia_rosmarinata	Larentiinae
Eupithecia_exiguata	Larentiinae
Eupithecia_semigraphata	Larentiinae
Eupithecia_weissi	Larentiinae
Eupithecia_subfuscata	Larentiinae
Colostygia_tempestaria	Larentiinae
Colostygia_kollariaria	Larentiinae
Colostygia_austriacaria	Larentiinae
Eulithis_peloponnesiaca	Larentiinae
Thera_cupressata	Larentiinae
Asthena_anseraria	Larentiinae
Asthena_albulata	Larentiinae
Venusia_blomeri	Larentiinae
Venusia_cambrica	Larentiinae
Epirrita_terminassianae	Larentiinae
Epirrita_dilutata	Larentiinae
Aplocera_efformata	Larentiinae
Aplocera_columbata	Larentiinae
Carsia_sororiata	Larentiinae
Lithostege_duponcheli	Larentiinae
Lithostege_griseata	Larentiinae
Nebula_carlae	Larentiinae
Nebula_achromaria	Larentiinae
Nebula_pirinica	Larentiinae
Nebula_nebulata	Larentiinae
Horisme_scorteata	Larentiinae
Horisme_vitalbata	Larentiinae
Eupithecia_tenuiata	Larentiinae
Colostygia_cyrnea	Larentiinae
Colostygia_olivata	Larentiinae
Colostygia_turbata	Larentiinae
Eulithis_populata	Larentiinae
Eulithis_prunata	Larentiinae
Thera_variata	Larentiinae
Thera_britannica	Larentiinae
Thera_cembrae	Larentiinae
Thera_vetustata	Larentiinae
Thera_obeliscata	Larentiinae
Perizoma_juracolaria	Larentiinae
Perizoma_obsoletata	Larentiinae
Perizoma_albulata	Larentiinae
Aplocera_corsalta	Larentiinae
Aplocera_plagiata	Larentiinae
Coenotephria_salicata	Larentiinae
Coenotephria_ablutaria	Larentiinae
Coenotephria_antonii	Larentiinae
Coenotephria_tophaceata	Larentiinae
Horisme_predotai	Larentiinae
Horisme_exoletata	Larentiinae
Horisme_calligraphata	Larentiinae
Eupithecia_inturbata	Larentiinae
Eupithecia_tantillaria	Larentiinae
Colostygia_stilpna	Larentiinae
Colostygia_aqueata	Larentiinae
Colostygia_hilariata	Larentiinae
Colostygia_wolfschlaegerae	Larentiinae
Colostygia_laetaria	Larentiinae
Colostygia_puengeleri	Larentiinae
Perizoma_minorata	Larentiinae
Horisme_tersata	Larentiinae
Horisme_radicaria	Larentiinae
Perizoma_bifaciata	Larentiinae
Perizoma_blandiata	Larentiinae
Lasiocampa_quercus	Lasiocampidae
Lasiocampa_trifolii	Lasiocampidae
Malacosoma_neustria	Lasiocampidae
Malacosoma_castrensis	Lasiocampidae
Malacosoma_alpicola	Lasiocampidae
Phyllodesma_suberifolia	Lasiocampidae
Phyllodesma_japonica	Lasiocampidae
Phyllodesma_tremulifolia	Lasiocampidae
Phyllodesma_ilicifolia	Lasiocampidae
Odonestis_pruni	Lasiocampidae
Gastropacha_populifolia	Lasiocampidae
Gastropacha_quercifolia	Lasiocampidae
Dendrolimus_pini	Lasiocampidae
Macrothylacia_rubi	Lasiocampidae
Euthrix_potatoria	Lasiocampidae
Cosmotriche_lobulina	Lasiocampidae
Eriogaster_catax	Lasiocampidae
Eriogaster_arbusculae	Lasiocampidae
Eriogaster_lanestris	Lasiocampidae
Trichiura_verenae	Lasiocampidae
Poecilocampa_populi	Lasiocampidae
Poecilocampa_alpina	Lasiocampidae
Poecilocampa_coluchei	Lasiocampidae
Trichiura_castiliana	Lasiocampidae
Trichiura_crataegi	Lasiocampidae
Leptotes_pirithous	Lycaenidae
Lycaena_thersamon	Lycaenidae
Callophrys_rubi	Lycaenidae
Lycaena_hippothoe	Lycaenidae
Cacyreus_marshalli	Lycaenidae
Lampides_boeticus	Lycaenidae
Cupido_osiris	Lycaenidae
Satyrium_pruni	Lycaenidae
Favonius_quercus	Lycaenidae
Thecla_betulae	Lycaenidae
Lycaena_tityrus	Lycaenidae
Lycaena_virgaureae	Lycaenidae
Lycaena_phlaeas	Lycaenidae
Cupido_minimus	Lycaenidae
Celastrina_argiolus	Lycaenidae
Satyrium_walbum	Lycaenidae
Lycaena_alciphron	Lycaenidae
Cupido_argiades	Lycaenidae
Glaucopsyche_alexis	Lycaenidae
Satyrium_ilicis	Lycaenidae
Lycaena_dispar	Lycaenidae
Lycaena_helle	Lycaenidae
Cupido_alcetas	Lycaenidae
Cupido_decolorata	Lycaenidae
Scolitantides_orion	Lycaenidae
Phengaris_rebeli	Lycaenidae
Phengaris_alcon	Lycaenidae
Phengaris_arion	Lycaenidae
Plebejus_argus	Lycaenidae
Satyrium_acaciae	Lycaenidae
Satyrium_spini	Lycaenidae
Pseudophilotes_bavius	Lycaenidae
Phengaris_nausithous	Lycaenidae
Phengaris_teleius	Lycaenidae
Plebejus_idas	Lycaenidae
Plebejus_argyrognomon	Lycaenidae
Pseudophilotes_baton	Lycaenidae
Pseudophilotes_vicrama	Lycaenidae
Polyommatus_amandus	Lycaenidae
Lysandra_bellargus	Lycaenidae
Lysandra_coridon	Lycaenidae
Aricia_nicias	Lycaenidae
Polyommatus_dolus	Lycaenidae
Kretania_sephirus	Lycaenidae
Eumedonia_eumedon	Lycaenidae
Aricia_agestis	Lycaenidae
Aricia_artaxerxes	Lycaenidae
Polyommatus_daphnis	Lycaenidae
Cyaniris_semiargus	Lycaenidae
Plebejus_orbitulus	Lycaenidae
Plebejus_optilete	Lycaenidae
Polyommatus_thersites	Lycaenidae
Plebejus_glandon	Lycaenidae
Agriades_aquilo	Lycaenidae
Polyommatus_damon	Lycaenidae
Polyommatus_dorylas	Lycaenidae
Polyommatus_icarus	Lycaenidae
Polyommatus_eros	Lycaenidae
Leucoptera_sinuella	Lyonetiidae
Phyllobrostis_hartmanni	Lyonetiidae
Lyonetia_clerkella	Lyonetiidae
Leucoptera_lustratella	Lyonetiidae
Lyonetia_ledi	Lyonetiidae
Leucoptera_malifoliella	Lyonetiidae
Lyonetia_pulverulentella	Lyonetiidae
Lyonetia_prunifoliella	Lyonetiidae
Leucoptera_spartifoliella	Lyonetiidae
Leucoptera_laburnella	Lyonetiidae
Leucoptera_orobi	Lyonetiidae
Leucoptera_lathyrifoliella	Lyonetiidae
Lypusa_tokari	Lypusidae
Lypusa_maurella	Lypusidae
Pseudatemelia_flavifrontella	Lypusidae
Pseudatemelia_latipennella	Lypusidae
Pseudatemelia_subochreella	Lypusidae
Pseudatemelia_synchrozella	Lypusidae
Amphisbatis_incongruella	Lypusidae
Pseudatemelia_elsae	Lypusidae
Pseudatemelia_josephinae	Lypusidae
Micropterix_osthelderi	Micropterigidae
Micropterix_allionella	Micropterigidae
Micropterix_aureoviridella	Micropterigidae
Micropterix_aureatella	Micropterigidae
Micropterix_aruncella	Micropterigidae
Micropterix_schaefferi	Micropterigidae
Micropterix_rothenbachii	Micropterigidae
Micropterix_calthella	Micropterigidae
Micropterix_tunbergella	Micropterigidae
Urodeta_hibernella	Momphidae
Mompha_subbistrigella	Momphidae
Mompha_epilobiella	Momphidae
Mompha_sturnipennella	Momphidae
Mompha_langiella	Momphidae
Mompha_divisella	Momphidae
Mompha_conturbatella	Momphidae
Mompha_locupletella	Momphidae
Mompha_terminella	Momphidae
Mompha_propinquella	Momphidae
Mompha_miscella	Momphidae
Mompha_idaei	Momphidae
Mompha_raschkiella	Momphidae
Mompha_sexstrigella	Momphidae
Mompha_ochraceella	Momphidae
Mompha_lacteella	Momphidae
Stigmella_lonicerarum	Nepticulidae
Stigmella_hybnerella	Nepticulidae
Stigmella_naturnella	Nepticulidae
Stigmella_minusculella	Nepticulidae
Stigmella_plagicolella	Nepticulidae
Ectoedemia_spiraeae	Nepticulidae
Ectoedemia_agrimoniae	Nepticulidae
Ectoedemia_mahalebella	Nepticulidae
Ectoedemia_spinosella	Nepticulidae
Stigmella_ulmivora	Nepticulidae
Stigmella_magdalenae	Nepticulidae
Ectoedemia_erythrogenella	Nepticulidae
Ectoedemia_rosae	Nepticulidae
Ectoedemia_albibimaculella	Nepticulidae
Ectoedemia_amani	Nepticulidae
Ectoedemia_weaveri	Nepticulidae
Ectoedemia_septembrella	Nepticulidae
Bohemannia_quadrimaculella	Nepticulidae
Stigmella_aceris	Nepticulidae
Stigmella_prunetorum	Nepticulidae
Bohemannia_pulverosella	Nepticulidae
Stigmella_oxyacanthella	Nepticulidae
Ectoedemia_terebinthivora	Nepticulidae
Ectoedemia_decentella	Nepticulidae
Ectoedemia_atrifrontella	Nepticulidae
Stigmella_betulicola	Nepticulidae
Stigmella_microtheriella	Nepticulidae
Enteucha_acetosae	Nepticulidae
Trifurcula_immundella	Nepticulidae
Stigmella_pyri	Nepticulidae
Stigmella_nylandriella	Nepticulidae
Stigmella_benanderella	Nepticulidae
Stigmella_trimaculella	Nepticulidae
Stigmella_assimilella	Nepticulidae
Ectoedemia_preisseckeri	Nepticulidae
Ectoedemia_intimella	Nepticulidae
Ectoedemia_louisella	Nepticulidae
Ectoedemia_sericopeza	Nepticulidae
Ectoedemia_reichli	Nepticulidae
Stigmella_alnetella	Nepticulidae
Stigmella_glutinosae	Nepticulidae
Stigmella_tiliae	Nepticulidae
Stigmella_luteella	Nepticulidae
Trifurcula_headleyella	Nepticulidae
Trifurcula_thymi	Nepticulidae
Trifurcula_beirnei	Nepticulidae
Trifurcula_subnitidella	Nepticulidae
Stigmella_lediella	Nepticulidae
Ectoedemia_minimella	Nepticulidae
Ectoedemia_angulifasciella	Nepticulidae
Ectoedemia_rufifrontella	Nepticulidae
Ectoedemia_turbidella	Nepticulidae
Ectoedemia_liebwerdella	Nepticulidae
Ectoedemia_longicaudella	Nepticulidae
Stigmella_salicis_cluster5	Nepticulidae
Stigmella_continuella	Nepticulidae
Stigmella_lemniscella	Nepticulidae
Stigmella_aeneofasciella	Nepticulidae
Stigmella_atricapitella	Nepticulidae
Stigmella_ruficapitella	Nepticulidae
Stigmella_pretiosa	Nepticulidae
Stigmella_aurella	Nepticulidae
Stigmella_poterii	Nepticulidae
Stigmella_filipendulae	Nepticulidae
Ectoedemia_occultella	Nepticulidae
Ectoedemia_atricollis	Nepticulidae
Ectoedemia_arcuatella	Nepticulidae
Ectoedemia_rubivora	Nepticulidae
Ectoedemia_hannoverella	Nepticulidae
Stigmella_salicis_Sardinia	Nepticulidae
Stigmella_myrtillella	Nepticulidae
Stigmella_salicis_cluster3	Nepticulidae
Stigmella_obliquella	Nepticulidae
Stigmella_tormentillella	Nepticulidae
Stigmella_tristis	Nepticulidae
Stigmella_basiguttella	Nepticulidae
Stigmella_samiatella	Nepticulidae
Stigmella_roborella	Nepticulidae
Ectoedemia_caradjai	Nepticulidae
Ectoedemia_klimeschi	Nepticulidae
Ectoedemia_argyropeza	Nepticulidae
Stigmella_salicis_cluster4	Nepticulidae
Stigmella_zelleriella	Nepticulidae
Stigmella_dryadella	Nepticulidae
Stigmella_splendidissimella	Nepticulidae
Stigmella_auromarginella	Nepticulidae
Stigmella_hemargyrella	Nepticulidae
Stigmella_suberivora	Nepticulidae
Ectoedemia_suberis	Nepticulidae
Ectoedemia_algeriensis	Nepticulidae
Ectoedemia_phyllotomella	Nepticulidae
Ectoedemia_subbimaculella	Nepticulidae
Ectoedemia_heringi	Nepticulidae
Ectoedemia_liechtensteini	Nepticulidae
Ectoedemia_pubescivora	Nepticulidae
Stigmella_salicis_cluster2	Nepticulidae
Stigmella_salicis	Nepticulidae
Stigmella_salicis_cluster6	Nepticulidae
Stigmella_vimineticola	Nepticulidae
Stigmella_sorbi	Nepticulidae
Stigmella_floslactella	Nepticulidae
Stigmella_tityrella	Nepticulidae
Stigmella_johanssonella	Nepticulidae
Stigmella_perpygmaeella	Nepticulidae
Stigmella_incognitella	Nepticulidae
Stigmella_sanguisorbae	Nepticulidae
Ectoedemia_andalusiae	Nepticulidae
Ectoedemia_leucothorax	Nepticulidae
Ectoedemia_haraldi	Nepticulidae
Ectoedemia_pseudoilicis	Nepticulidae
Ectoedemia_gilvipennella	Nepticulidae
Ectoedemia_cerris	Nepticulidae
Stigmella_lapponica	Nepticulidae
Stigmella_confusella	Nepticulidae
Stigmella_malella	Nepticulidae
Stigmella_catharticella	Nepticulidae
Stigmella_centifoliella	Nepticulidae
Stigmella_anomalella	Nepticulidae
Ectoedemia_phaeolepis	Nepticulidae
Ectoedemia_heringella	Nepticulidae
Ectoedemia_ilicis	Nepticulidae
Ectoedemia_coscoja	Nepticulidae
Ectoedemia_quinquella	Nepticulidae
Ectoedemia_contorta	Nepticulidae
Ectoedemia_albifasciella	Nepticulidae
Ectoedemia_hendrikseni	Nepticulidae
Ectoedemia_heckfordi	Nepticulidae
Chloantha_hyperici	Noctuidae_Noctuinae
Actinotia_radiosa	Noctuidae_Noctuinae
Actinotia_polyodon	Noctuidae_Noctuinae
Charanyca_ferruginea	Noctuidae_Noctuinae
Chilodes_maritima	Noctuidae_Noctuinae
Ochropleura_leucogaster	Noctuidae_Noctuinae
Ochropleura_plecta	Noctuidae_Noctuinae
Lasionycta_imbecilla	Noctuidae_Noctuinae
Athetis_gluteosa	Noctuidae_Noctuinae
Athetis_pallustris	Noctuidae_Noctuinae
Athetis_lepigone	Noctuidae_Noctuinae
Athetis_hospes	Noctuidae_Noctuinae
Lycophotia_porphyrea	Noctuidae_Noctuinae
Polyphaenis_sericata	Noctuidae_Noctuinae
Thalpophila_matura	Noctuidae_Noctuinae
Hoplodrina_ambigua	Noctuidae_Noctuinae
Euxoa_adumbrata	Noctuidae_Noctuinae
Episema_glaucina	Noctuidae_Noctuinae
Episema_korsakovi	Noctuidae_Noctuinae
Caradrina_fuscicornis	Noctuidae_Noctuinae
Caradrina_flavirena	Noctuidae_Noctuinae
Caradrina_clavipalpis	Noctuidae_Noctuinae
Caradrina_selini	Noctuidae_Noctuinae
Caradrina_levantina	Noctuidae_Noctuinae
Charanyca_trigrammica	Noctuidae_Noctuinae
Eugraphe_sigma	Noctuidae_Noctuinae
Eugnorisma_glareosa	Noctuidae_Noctuinae
Graphiphora_augur	Noctuidae_Noctuinae
Actebia_fennica	Noctuidae_Noctuinae
Actebia_praecox	Noctuidae_Noctuinae
Mormo_maura	Noctuidae_Noctuinae
Auchmis_detersa	Noctuidae_Noctuinae
Phlogophora_scita	Noctuidae_Noctuinae
Euplexia_lucipara	Noctuidae_Noctuinae
Phlogophora_meticulosa	Noctuidae_Noctuinae
Caradrina_kadenii	Noctuidae_Noctuinae
Euxoa_ochrogaster	Noctuidae_Noctuinae
Euxoa_cursoria	Noctuidae_Noctuinae
Euxoa_birivia	Noctuidae_Noctuinae
Conistra_erythrocephala	Noctuidae_Noctuinae
Lasionycta_proxima	Noctuidae_Noctuinae
Phlogophora_wollastoni	Noctuidae_Noctuinae
Caradrina_albina	Noctuidae_Noctuinae
Caradrina_montana	Noctuidae_Noctuinae
Caradrina_gilva	Noctuidae_Noctuinae
Caradrina_morpheus	Noctuidae_Noctuinae
Hoplodrina_blanda	Noctuidae_Noctuinae
Hoplodrina_respersa	Noctuidae_Noctuinae
Hoplodrina_octogenaria	Noctuidae_Noctuinae
Hoplodrina_superstes	Noctuidae_Noctuinae
Agrotis_ipsilon	Noctuidae_Noctuinae
Agrotis_simplonia	Noctuidae_Noctuinae
Dichagyris_renigera	Noctuidae_Noctuinae
Dasypolia_esseri	Noctuidae_Noctuinae
Dasypolia_templi	Noctuidae_Noctuinae
Tiliacea_citrago	Noctuidae_Noctuinae
Perigrapha_icinctum	Noctuidae_Noctuinae
Phlogophora_furnasi	Noctuidae_Noctuinae
Caradrina_flava	Noctuidae_Noctuinae
Caradrina_terrea	Noctuidae_Noctuinae
Lycophotia_molothina	Noctuidae_Noctuinae
Euxoa_distinguenda	Noctuidae_Noctuinae
Euxoa_temera	Noctuidae_Noctuinae
Agrotis_catalaunensis	Noctuidae_Noctuinae
Dichagyris_nigrescens	Noctuidae_Noctuinae
Dichagyris_constanti	Noctuidae_Noctuinae
Actebia_fugax	Noctuidae_Noctuinae
Actebia_squalida	Noctuidae_Noctuinae
Hyppa_rectilinea	Noctuidae_Noctuinae
Scotochrosta_pulla	Noctuidae_Noctuinae
Agrochola_laevis	Noctuidae_Noctuinae
Eupsilia_transversa	Noctuidae_Noctuinae
Tiliacea_aurago	Noctuidae_Noctuinae
Evisa_schawerdae	Noctuidae_Noctuinae
Parastichtis_suspecta	Noctuidae_Noctuinae
Apterogenum_ypsillon	Noctuidae_Noctuinae
Heterophysa_dumetorum	Noctuidae_Noctuinae
Elaphria_venustula	Noctuidae_Noctuinae
Trachea_atriplicis	Noctuidae_Noctuinae
Dypterygia_scabriuscula	Noctuidae_Noctuinae
Senta_flammea	Noctuidae_Noctuinae
Pachetra_sagittigera	Noctuidae_Noctuinae
Brithys_crini	Noctuidae_Noctuinae
Lasionycta_staudingeri	Noctuidae_Noctuinae
Lasionycta_leucocycla	Noctuidae_Noctuinae
Lasionycta_secedens	Noctuidae_Noctuinae
Lasionycta_skraelingia	Noctuidae_Noctuinae
Phlogophora_cabrali	Noctuidae_Noctuinae
Caradrina_noctivaga	Noctuidae_Noctuinae
Caradrina_aspersa	Noctuidae_Noctuinae
Caradrina_ibeasi	Noctuidae_Noctuinae
Rhyacia_lucipeta	Noctuidae_Noctuinae
Paradiarsia_punicea	Noctuidae_Noctuinae
Opigena_polygona	Noctuidae_Noctuinae
Diarsia_florida	Noctuidae_Noctuinae
Diarsia_rubi	Noctuidae_Noctuinae
Euxoa_cos	Noctuidae_Noctuinae
Euxoa_culminicola	Noctuidae_Noctuinae
Euxoa_recussa	Noctuidae_Noctuinae
Agrotis_puta	Noctuidae_Noctuinae
Agrotis_schawerdai	Noctuidae_Noctuinae
Dichagyris_forcipula	Noctuidae_Noctuinae
Dichagyris_celsicola	Noctuidae_Noctuinae
Peridroma_saucia	Noctuidae_Noctuinae
Mesogona_oxalina	Noctuidae_Noctuinae
Mesogona_acetosellae	Noctuidae_Noctuinae
Dicycla_oo	Noctuidae_Noctuinae
Ipimorpha_contusa	Noctuidae_Noctuinae
Mythimna_unipuncta	Noctuidae_Noctuinae
Polia_hepatica	Noctuidae_Noctuinae
Egira_conspicillaris	Noctuidae_Noctuinae
Panolis_flammea	Noctuidae_Noctuinae
Orthosia_incerta	Noctuidae_Noctuinae
Coranarta_cordigera	Noctuidae_Noctuinae
Phlogophora_interrupta	Noctuidae_Noctuinae
Phlogophora_kruegeri	Noctuidae_Noctuinae
Caradrina_draudti	Noctuidae_Noctuinae
Caradrina_armeniaca	Noctuidae_Noctuinae
Chersotis_rectangula	Noctuidae_Noctuinae
Chersotis_andereggii	Noctuidae_Noctuinae
Diarsia_guadarramensis	Noctuidae_Noctuinae
Diarsia_brunnea	Noctuidae_Noctuinae
Diarsia_dahlii	Noctuidae_Noctuinae
Diarsia_mendica	Noctuidae_Noctuinae
Axylia_putris	Noctuidae_Noctuinae
Cerastis_faceta	Noctuidae_Noctuinae
Euxoa_decora	Noctuidae_Noctuinae
Agrotis_lasserrei	Noctuidae_Noctuinae
Agrotis_lata	Noctuidae_Noctuinae
Agrotis_bigramma	Noctuidae_Noctuinae
Agrotis_clavis	Noctuidae_Noctuinae
Agrotis_fatidica	Noctuidae_Noctuinae
Dichagyris_candelisequa	Noctuidae_Noctuinae
Dryobotodes_roboris	Noctuidae_Noctuinae
Griposia_skyvai	Noctuidae_Noctuinae
Dichonia_aeruginea	Noctuidae_Noctuinae
Dichonia_convergens	Noctuidae_Noctuinae
Enargia_paleacea	Noctuidae_Noctuinae
Cosmia_trapezina	Noctuidae_Noctuinae
Leucania_loreyi	Noctuidae_Noctuinae
Polia_nebulosa	Noctuidae_Noctuinae
Sideridis_reticulata	Noctuidae_Noctuinae
Sideridis_kitti	Noctuidae_Noctuinae
Hyssia_cavernosa	Noctuidae_Noctuinae
Standfussiana_lucernea	Noctuidae_Noctuinae
Standfussiana_wiskotti	Noctuidae_Noctuinae
Epipsilia_grisescens	Noctuidae_Noctuinae
Epipsilia_latens	Noctuidae_Noctuinae
Rhyacia_simulans	Noctuidae_Noctuinae
Protolampra_sobrina	Noctuidae_Noctuinae
Naenia_typica	Noctuidae_Noctuinae
Xestia_mejiasi	Noctuidae_Noctuinae
Lycophotia_erythrina	Noctuidae_Noctuinae
Eugnorisma_depuncta	Noctuidae_Noctuinae
Cerastis_rubricosa	Noctuidae_Noctuinae
Cerastis_leucographa	Noctuidae_Noctuinae
Euxoa_nigricans	Noctuidae_Noctuinae
Agrotis_trux	Noctuidae_Noctuinae
Agrotis_atrux	Noctuidae_Noctuinae
Agrotis_ripae	Noctuidae_Noctuinae
Dichagyris_musiva	Noctuidae_Noctuinae
Gortyna_flavago	Noctuidae_Noctuinae
Fabula_zollikoferi	Noctuidae_Noctuinae
Apamea_illyria	Noctuidae_Noctuinae
Gortyna_xanthenes	Noctuidae_Noctuinae
Spodoptera_exigua	Noctuidae_Noctuinae
Apamea_oblonga	Noctuidae_Noctuinae
Luperina_dumerilii	Noctuidae_Noctuinae
Photedes_extrema	Noctuidae_Noctuinae
Lenisa_geminipuncta	Noctuidae_Noctuinae
Archanara_neurica	Noctuidae_Noctuinae
Globia_sparganii	Noctuidae_Noctuinae
Mesapamea_secalis	Noctuidae_Noctuinae
Apamea_schildei	Noctuidae_Noctuinae
Hydraecia_petasitis	Noctuidae_Noctuinae
Dryobotodes_tenebrosa	Noctuidae_Noctuinae
Calamia_tridens	Noctuidae_Noctuinae
Apamea_rubrirena	Noctuidae_Noctuinae
Apamea_sublustris	Noctuidae_Noctuinae
Oligia_latruncula	Noctuidae_Noctuinae
Gortyna_borelii	Noctuidae_Noctuinae
Mesoligia_furuncula	Noctuidae_Noctuinae
Denticucullus_pygmina	Noctuidae_Noctuinae
Pabulatrix_pabulatricula	Noctuidae_Noctuinae
Dryobotodes_monochroma	Noctuidae_Noctuinae
Protarchanara_brevilinea	Noctuidae_Noctuinae
Oligia_fasciuncula	Noctuidae_Noctuinae
Apamea_monoglypha	Noctuidae_Noctuinae
Photedes_captiuncula	Noctuidae_Noctuinae
Apamea_lithoxylaea	Noctuidae_Noctuinae
Eremobia_ochroleuca	Noctuidae_Noctuinae
Archanara_dissoluta	Noctuidae_Noctuinae
Apamea_epomidion	Noctuidae_Noctuinae
Apamea_aquila	Noctuidae_Noctuinae
Apamea_lateritia	Noctuidae_Noctuinae
Rhizedra_lutosa	Noctuidae_Noctuinae
Hydraecia_ultima	Noctuidae_Noctuinae
Celaena_haworthii	Noctuidae_Noctuinae
Amphipoea_crinanensis	Noctuidae_Noctuinae
Globia_algae	Noctuidae_Noctuinae
Xylomoia_stangelmaieri	Noctuidae_Noctuinae
Apamea_anceps	Noctuidae_Noctuinae
Mesapamea_secalella	Noctuidae_Noctuinae
Photedes_minima	Noctuidae_Noctuinae
Mesapamea_storai	Noctuidae_Noctuinae
Apamea_syriaca	Noctuidae_Noctuinae
Phragmatiphila_nexa	Noctuidae_Noctuinae
Dryobotodes_eremita	Noctuidae_Noctuinae
Apamea_unanimis	Noctuidae_Noctuinae
Amphipoea_lucens	Noctuidae_Noctuinae
Longalatedes_elymi	Noctuidae_Noctuinae
Apamea_furva	Noctuidae_Noctuinae
Nonagria_typhae	Noctuidae_Noctuinae
Apamea_crenata	Noctuidae_Noctuinae
Apamea_scolopacina	Noctuidae_Noctuinae
Photedes_morrisii	Noctuidae_Noctuinae
Helotropha_leucostigma	Noctuidae_Noctuinae
Sedina_buettneri	Noctuidae_Noctuinae
Arenostola_phragmitidis	Noctuidae_Noctuinae
Apamea_sordens	Noctuidae_Noctuinae
Xylomoia_strix	Noctuidae_Noctuinae
Apamea_maillardi	Noctuidae_Noctuinae
Hydraecia_micacea	Noctuidae_Noctuinae
Amphipoea_oculea	Noctuidae_Noctuinae
Brachylomia_viminalis	Noctuidae_Noctuinae
Mythimna_riparia	Noctuidae_Noctuinae
Lateroligia_ophiogramma	Noctuidae_Noctuinae
Hydraecia_osseola	Noctuidae_Noctuinae
Apamea_platinea	Noctuidae_Noctuinae
Apamea_remissa	Noctuidae_Noctuinae
Oligia_dubia	Noctuidae_Noctuinae
Luperina_nickerlii	Noctuidae_Noctuinae
Coenobia_rufa	Noctuidae_Noctuinae
Amphipoea_fucosa	Noctuidae_Noctuinae
Crypsedra_gemmea	Noctuidae_Noctuinae
Apamea_zeta	Noctuidae_Noctuinae
Photedes_fluxa	Noctuidae_Noctuinae
Oligia_strigilis	Noctuidae_Noctuinae
Oligia_versicolor	Noctuidae_Noctuinae
Staurophora_celsia	Noctuidae_Noctuinae
Luperina_testacea	Noctuidae_Noctuinae
Litoligia_literosa	Noctuidae_Noctuinae
Photedes_dulcis	Noctuidae_Noctuinae
Hydraecia_nordstroemi	Noctuidae_Noctuinae
Leucochlaena_oditis	Noctuidae_Noctuinae
Leucochlaena_turatii	Noctuidae_Noctuinae
Griposia_aprilina	Noctuidae_Noctuinae
Griposia_wegneri	Noctuidae_Noctuinae
Lithophane_ornitopus	Noctuidae_Noctuinae
Lithophane_leautieri	Noctuidae_Noctuinae
Lithophane_lamda	Noctuidae_Noctuinae
Eremohadena_mariana	Noctuidae_Noctuinae
Atethmia_centrago	Noctuidae_Noctuinae
Polia_bombycina	Noctuidae_Noctuinae
Orthosia_opima	Noctuidae_Noctuinae
Orthosia_gracilis	Noctuidae_Noctuinae
Conisania_leineri	Noctuidae_Noctuinae
Mamestra_brassicae	Noctuidae_Noctuinae
Anarta_sodae	Noctuidae_Noctuinae
Anarta_stigmosa	Noctuidae_Noctuinae
Anarta_melanopa	Noctuidae_Noctuinae
Tholera_cespitis	Noctuidae_Noctuinae
Chersotis_alpestris	Noctuidae_Noctuinae
Chersotis_andreae	Noctuidae_Noctuinae
Chersotis_multangula	Noctuidae_Noctuinae
Spaelotis_ravida	Noctuidae_Noctuinae
Anaplectoides_prasina	Noctuidae_Noctuinae
Pseudeustrotia_candidula	Noctuidae_Noctuinae
Xestia_kermesina	Noctuidae_Noctuinae
Xestia_lyngei	Noctuidae_Noctuinae
Xestia_collina	Noctuidae_Noctuinae
Euxoa_tritici	Noctuidae_Noctuinae
Euxoa_obelisca	Noctuidae_Noctuinae
Euxoa_segnilis	Noctuidae_Noctuinae
Euxoa_pareruta	Noctuidae_Noctuinae
Euxoa_powelli	Noctuidae_Noctuinae
Euxoa_vitta	Noctuidae_Noctuinae
Euxoa_aquilina	Noctuidae_Noctuinae
Agrotis_exclamationis	Noctuidae_Noctuinae
Agrotis_segetum	Noctuidae_Noctuinae
Agrotis_vestigialis	Noctuidae_Noctuinae
Agrotis_graslini	Noctuidae_Noctuinae
Agrotis_turatii	Noctuidae_Noctuinae
Agrotis_cinerea	Noctuidae_Noctuinae
Dichagyris_flammatra	Noctuidae_Noctuinae
Dichagyris_signifera	Noctuidae_Noctuinae
Lithophane_semibrunnea	Noctuidae_Noctuinae
Agrochola_lychnidis	Noctuidae_Noctuinae
Agrochola_litura	Noctuidae_Noctuinae
Xanthia_ruticilla	Noctuidae_Noctuinae
Eremohadena_halimi	Noctuidae_Noctuinae
Eremohadena_immunda	Noctuidae_Noctuinae
Rileyiana_fovea	Noctuidae_Noctuinae
Polia_conspicua	Noctuidae_Noctuinae
Orthosia_miniosa	Noctuidae_Noctuinae
Orthosia_cruda	Noctuidae_Noctuinae
Melanchra_persicariae	Noctuidae_Noctuinae
Lacanobia_splendens	Noctuidae_Noctuinae
Lacanobia_oleracea	Noctuidae_Noctuinae
Hecatera_bicolorata	Noctuidae_Noctuinae
Hecatera_dysodea	Noctuidae_Noctuinae
Anarta_myrtilli	Noctuidae_Noctuinae
Sideridis_rivularis	Noctuidae_Noctuinae
Cerapteryx_graminis	Noctuidae_Noctuinae
Tholera_decimalis	Noctuidae_Noctuinae
Chersotis_larixia	Noctuidae_Noctuinae
Chersotis_anatolica	Noctuidae_Noctuinae
Chersotis_ocellina	Noctuidae_Noctuinae
Chersotis_oreina	Noctuidae_Noctuinae
Spaelotis_suecica	Noctuidae_Noctuinae
Spaelotis_senna	Noctuidae_Noctuinae
Epilecta_linogrisea	Noctuidae_Noctuinae
Mniotype_spinosa	Noctuidae_Noctuinae
Mniotype_solieri	Noctuidae_Noctuinae
Mniotype_albostigmata	Noctuidae_Noctuinae
Polymixis_dubia	Noctuidae_Noctuinae
Polymixis_argillaceago	Noctuidae_Noctuinae
Lithophane_consocia	Noctuidae_Noctuinae
Agrochola_pistacinoides	Noctuidae_Noctuinae
Agrochola_nitida	Noctuidae_Noctuinae
Agrochola_humilis	Noctuidae_Noctuinae
Agrochola_meridionalis	Noctuidae_Noctuinae
Xylena_exsoleta	Noctuidae_Noctuinae
Atypha_pulmonaris	Noctuidae_Noctuinae
Leucania_zeae	Noctuidae_Noctuinae
Leucania_obsoleta	Noctuidae_Noctuinae
Leucania_comma	Noctuidae_Noctuinae
Leucania_joannisi	Noctuidae_Noctuinae
Mythimna_umbrigera	Noctuidae_Noctuinae
Polia_serratilinea	Noctuidae_Noctuinae
Orthosia_cerasi	Noctuidae_Noctuinae
Orthosia_populeti	Noctuidae_Noctuinae
Anorthoa_munda	Noctuidae_Noctuinae
Sideridis_lampra	Noctuidae_Noctuinae
Sideridis_turbida	Noctuidae_Noctuinae
Lacanobia_thalassina	Noctuidae_Noctuinae
Lacanobia_suasa	Noctuidae_Noctuinae
Anarta_odontites	Noctuidae_Noctuinae
Anarta_trifolii	Noctuidae_Noctuinae
Hadena_albimacula	Noctuidae_Noctuinae
Hadena_confusa	Noctuidae_Noctuinae
Chersotis_cyrnea	Noctuidae_Noctuinae
Chersotis_margaritacea	Noctuidae_Noctuinae
Rhyacia_helvetina	Noctuidae_Noctuinae
Xestia_ashworthii	Noctuidae_Noctuinae
Xestia_cnigrum	Noctuidae_Noctuinae
Xestia_ditrapezium	Noctuidae_Noctuinae
Xestia_triangulum	Noctuidae_Noctuinae
Eurois_occulta	Noctuidae_Noctuinae
Mniotype_anilis	Noctuidae_Noctuinae
Lithophane_furcifera	Noctuidae_Noctuinae
Lithophane_socia	Noctuidae_Noctuinae
Agrochola_helvola	Noctuidae_Noctuinae
Jodia_croceago	Noctuidae_Noctuinae
Xylena_vetusta	Noctuidae_Noctuinae
Leucania_fortunata	Noctuidae_Noctuinae
Polia_lamuta	Noctuidae_Noctuinae
Polia_richardsoni	Noctuidae_Noctuinae
Perigrapha_rorida	Noctuidae_Noctuinae
Orthosia_gothica	Noctuidae_Noctuinae
Lacanobia_contigua	Noctuidae_Noctuinae
Lacanobia_aliena	Noctuidae_Noctuinae
Enterpia_laudeti	Noctuidae_Noctuinae
Hada_plebeja	Noctuidae_Noctuinae
Hadena_compta	Noctuidae_Noctuinae
Conisania_behouneki	Noctuidae_Noctuinae
Conisania_luteago	Noctuidae_Noctuinae
Chersotis_fimbriola	Noctuidae_Noctuinae
Chersotis_cuprea	Noctuidae_Noctuinae
Noctua_noacki	Noctuidae_Noctuinae
Noctua_orbona	Noctuidae_Noctuinae
Xestia_sexstrigata	Noctuidae_Noctuinae
Xestia_agathina	Noctuidae_Noctuinae
Mniotype_bathensis	Noctuidae_Noctuinae
Mniotype_adusta	Noctuidae_Noctuinae
Trigonophora_haasi	Noctuidae_Noctuinae
Ammoconia_caecimacula	Noctuidae_Noctuinae
Aporophyla_lueneburgensis	Noctuidae_Noctuinae
Aporophyla_lutulenta	Noctuidae_Noctuinae
Aporophyla_nigra	Noctuidae_Noctuinae
Aporophyla_australis	Noctuidae_Noctuinae
Xanthia_gilvago	Noctuidae_Noctuinae
Conistra_gallica	Noctuidae_Noctuinae
Conistra_daubei	Noctuidae_Noctuinae
Conistra_torrida	Noctuidae_Noctuinae
Orbona_fragariae	Noctuidae_Noctuinae
Conistra_intricata	Noctuidae_Noctuinae
Conistra_veronicae	Noctuidae_Noctuinae
Agrochola_circellaris	Noctuidae_Noctuinae
Agrochola_lota	Noctuidae_Noctuinae
Cosmia_pyralina	Noctuidae_Noctuinae
Ipimorpha_subtusa	Noctuidae_Noctuinae
Leucania_putrescens	Noctuidae_Noctuinae
Leucania_punctosa	Noctuidae_Noctuinae
Mythimna_vitellina	Noctuidae_Noctuinae
Mythimna_pudorina	Noctuidae_Noctuinae
Mythimna_turca	Noctuidae_Noctuinae
Mythimna_lalbum	Noctuidae_Noctuinae
Mythimna_sicula	Noctuidae_Noctuinae
Mythimna_andereggii	Noctuidae_Noctuinae
Lacanobia_blenna	Noctuidae_Noctuinae
Lacanobia_wlatinum	Noctuidae_Noctuinae
Papestra_biren	Noctuidae_Noctuinae
Ceramica_pisi	Noctuidae_Noctuinae
Hadena_irregularis	Noctuidae_Noctuinae
Hadena_capsincola	Noctuidae_Noctuinae
Hadena_bicruris	Noctuidae_Noctuinae
Hadena_tephroleuca	Noctuidae_Noctuinae
Noctua_atlantica	Noctuidae_Noctuinae
Noctua_pronuba	Noctuidae_Noctuinae
Xestia_brunneopicta	Noctuidae_Noctuinae
Coenophila_subrosea	Noctuidae_Noctuinae
Xestia_speciosa	Noctuidae_Noctuinae
Xestia_viridescens	Noctuidae_Noctuinae
Xestia_jordani	Noctuidae_Noctuinae
Xestia_castanea	Noctuidae_Noctuinae
Mniotype_satura	Noctuidae_Noctuinae
Xanthia_icteritia	Noctuidae_Noctuinae
Xanthia_ocellaris	Noctuidae_Noctuinae
Conistra_alicia	Noctuidae_Noctuinae
Conistra_rubiginosa	Noctuidae_Noctuinae
Agrochola_blidaensis	Noctuidae_Noctuinae
Agrochola_macilenta	Noctuidae_Noctuinae
Xylena_solidaginis	Noctuidae_Noctuinae
Cosmia_diffinis	Noctuidae_Noctuinae
Cosmia_affinis	Noctuidae_Noctuinae
Cleoceris_scoriacea	Noctuidae_Noctuinae
Ipimorpha_retusa	Noctuidae_Noctuinae
Mythimna_algirica	Noctuidae_Noctuinae
Hadena_perplexa	Noctuidae_Noctuinae
Noctua_interposita	Noctuidae_Noctuinae
Noctua_comes	Noctuidae_Noctuinae
Noctua_interjecta	Noctuidae_Noctuinae
Xestia_lorezi	Noctuidae_Noctuinae
Polymixis_lichenea	Noctuidae_Noctuinae
Antitype_suda	Noctuidae_Noctuinae
Antitype_chi	Noctuidae_Noctuinae
Ammopolia_witzenmanni	Noctuidae_Noctuinae
Conistra_vaccinii	Noctuidae_Noctuinae
Conistra_ligula	Noctuidae_Noctuinae
Conistra_ragusae	Noctuidae_Noctuinae
Hillia_iris	Noctuidae_Noctuinae
Xanthia_togata	Noctuidae_Noctuinae
Mythimna_pallens	Noctuidae_Noctuinae
Mythimna_favicolor	Noctuidae_Noctuinae
Mythimna_straminea	Noctuidae_Noctuinae
Mythimna_albipuncta	Noctuidae_Noctuinae
Mythimna_ferrago	Noctuidae_Noctuinae
Hadena_silenes	Noctuidae_Noctuinae
Hadena_ruetimeyeri	Noctuidae_Noctuinae
Hadena_clara	Noctuidae_Noctuinae
Hadena_magnolii	Noctuidae_Noctuinae
Hadena_caesia	Noctuidae_Noctuinae
Cryptocala_chardinyi	Noctuidae_Noctuinae
Xestia_xanthographa	Noctuidae_Noctuinae
Xestia_sincera	Noctuidae_Noctuinae
Xestia_fennica	Noctuidae_Noctuinae
Trigonophora_jodea	Noctuidae_Noctuinae
Trigonophora_flammea	Noctuidae_Noctuinae
Polymixis_xanthomista	Noctuidae_Noctuinae
Mythimna_conigera	Noctuidae_Noctuinae
Mythimna_impura	Noctuidae_Noctuinae
Hadena_filograna	Noctuidae_Noctuinae
Xestia_baja	Noctuidae_Noctuinae
Xestia_ochreago	Noctuidae_Noctuinae
Xestia_quieta	Noctuidae_Noctuinae
Xestia_stigmatica	Noctuidae_Noctuinae
Conistra_staudingeri	Noctuidae_Noctuinae
Conistra_rubiginea	Noctuidae_Noctuinae
Agrochola_haematidea	Noctuidae_Noctuinae
Agrochola_lunosa	Noctuidae_Noctuinae
Hadena_orihuela	Noctuidae_Noctuinae
Hadena_luteocincta	Noctuidae_Noctuinae
Noctua_janthe	Noctuidae_Noctuinae
Noctua_tirrenica	Noctuidae_Noctuinae
Noctua_fimbriata	Noctuidae_Noctuinae
Xestia_atrata	Noctuidae_Noctuinae
Xestia_alpicola	Noctuidae_Noctuinae
Xestia_gelida	Noctuidae_Noctuinae
Blepharita_amica	Noctuidae_Noctuinae
Polymixis_polymita	Noctuidae_Noctuinae
Polymixis_rufocincta	Noctuidae_Noctuinae
Polymixis_flavicincta	Noctuidae_Noctuinae
Noctua_janthina	Noctuidae_Noctuinae
Noctua_tertia	Noctuidae_Noctuinae
Xestia_borealis	Noctuidae_Noctuinae
Xestia_tecta	Noctuidae_Noctuinae
Xestia_laetabilis	Noctuidae_Noctuinae
Xestia_distensa	Noctuidae_Noctuinae
Bryophila_raptricula	Noctuidae_non-Noctuinae
Metopoceras_albarracina	Noctuidae_non-Noctuinae
Sympistis_zetterstedtii	Noctuidae_non-Noctuinae
Valeria_jaspidea	Noctuidae_non-Noctuinae
Autographa_aemula	Noctuidae_non-Noctuinae
Lamprotes_caureum	Noctuidae_non-Noctuinae
Panthea_coenobita	Noctuidae_non-Noctuinae
Sympistis_lapponica	Noctuidae_non-Noctuinae
Sympistis_nigrita	Noctuidae_non-Noctuinae
Subacronicta_megacephala	Noctuidae_non-Noctuinae
Autographa_gamma	Noctuidae_non-Noctuinae
Shargacucullia_scrophulariae	Noctuidae_non-Noctuinae
Deltote_uncula	Noctuidae_non-Noctuinae
Panemeria_tenebrata	Noctuidae_non-Noctuinae
Calliergis_ramosa	Noctuidae_non-Noctuinae
Oxicesta_geographica	Noctuidae_non-Noctuinae
Macdunnoughia_confusa	Noctuidae_non-Noctuinae
Trichoplusia_ni	Noctuidae_non-Noctuinae
Calophasia_lunula	Noctuidae_non-Noctuinae
Nyctobrya_muralis	Noctuidae_non-Noctuinae
Amphipyra_pyramidea	Noctuidae_non-Noctuinae
Pyrrhia_umbra	Noctuidae_non-Noctuinae
Acronicta_euphorbiae	Noctuidae_non-Noctuinae
Cucullia_pustulata	Noctuidae_non-Noctuinae
Autographa_bractea	Noctuidae_non-Noctuinae
Acronicta_auricoma	Noctuidae_non-Noctuinae
Sympistis_heliophila	Noctuidae_non-Noctuinae
Syngrapha_ain	Noctuidae_non-Noctuinae
Callopistria_juventina	Noctuidae_non-Noctuinae
Autographa_mandarina	Noctuidae_non-Noctuinae
Omphalophana_antirrhinii	Noctuidae_non-Noctuinae
Acronicta_strigosa	Noctuidae_non-Noctuinae
Cucullia_chamomillae	Noctuidae_non-Noctuinae
Stilbia_anomala	Noctuidae_non-Noctuinae
Heliothis_nubigera	Noctuidae_non-Noctuinae
Simyra_albovenosa	Noctuidae_non-Noctuinae
Diachrysia_chryson	Noctuidae_non-Noctuinae
Thysanoplusia_orichalcea	Noctuidae_non-Noctuinae
Bryophila_ereptricula	Noctuidae_non-Noctuinae
Protoschinia_scutosa	Noctuidae_non-Noctuinae
Autographa_pulchrina	Noctuidae_non-Noctuinae
Syngrapha_parilis	Noctuidae_non-Noctuinae
Acronicta_aceris	Noctuidae_non-Noctuinae
Syngrapha_diasema	Noctuidae_non-Noctuinae
Stilbia_philopalis	Noctuidae_non-Noctuinae
Omphalophana_serrata	Noctuidae_non-Noctuinae
Nyctobrya_amasina	Noctuidae_non-Noctuinae
Moma_alpium	Noctuidae_non-Noctuinae
Euchalcia_variabilis	Noctuidae_non-Noctuinae
Pseudozarba_bipartita	Noctuidae_non-Noctuinae
Plusia_festucae	Noctuidae_non-Noctuinae
Asteroscopus_sphinx	Noctuidae_non-Noctuinae
Cucullia_xeranthemi	Noctuidae_non-Noctuinae
Cucullia_praecana	Noctuidae_non-Noctuinae
Trichosea_ludifica	Noctuidae_non-Noctuinae
Abrostola_tripartita	Noctuidae_non-Noctuinae
Amphipyra_cinnamomea	Noctuidae_non-Noctuinae
Syngrapha_interrogationis	Noctuidae_non-Noctuinae
Amephana_aurita	Noctuidae_non-Noctuinae
Cryphia_algae	Noctuidae_non-Noctuinae
Cucullia_gnaphalii	Noctuidae_non-Noctuinae
Plusia_putnami	Noctuidae_non-Noctuinae
Amphipyra_livida	Noctuidae_non-Noctuinae
Phyllophila_obliterata	Noctuidae_non-Noctuinae
Diloba_caeruleocephala	Noctuidae_non-Noctuinae
Tyta_luctuosa	Noctuidae_non-Noctuinae
Metopoceras_felicina	Noctuidae_non-Noctuinae
Shargacucullia_thapsiphaga	Noctuidae_non-Noctuinae
Diachrysia_nadeja	Noctuidae_non-Noctuinae
Synthymia_fixa	Noctuidae_non-Noctuinae
Diachrysia_chrysitis	Noctuidae_non-Noctuinae
Shargacucullia_caninae	Noctuidae_non-Noctuinae
Cleonymia_diffluens	Noctuidae_non-Noctuinae
Victrix_umovii	Noctuidae_non-Noctuinae
Amphipyra_berbera	Noctuidae_non-Noctuinae
Oxicesta_serratae	Noctuidae_non-Noctuinae
Acronicta_cuspis	Noctuidae_non-Noctuinae
Autographa_jota	Noctuidae_non-Noctuinae
Acronicta_menyanthidis	Noctuidae_non-Noctuinae
Amphipyra_tetra	Noctuidae_non-Noctuinae
Cleonymia_baetica	Noctuidae_non-Noctuinae
Cucullia_asteris	Noctuidae_non-Noctuinae
Shargacucullia_gozmanyi	Noctuidae_non-Noctuinae
Heliothis_peltigera	Noctuidae_non-Noctuinae
Brachionycha_nubeculosa	Noctuidae_non-Noctuinae
Cucullia_argentea	Noctuidae_non-Noctuinae
Abrostola_triplasia	Noctuidae_non-Noctuinae
Cucullia_lactucae	Noctuidae_non-Noctuinae
Panemeria_jocosa	Noctuidae_non-Noctuinae
Polychrysia_moneta	Noctuidae_non-Noctuinae
Diachrysia_zosimi	Noctuidae_non-Noctuinae
Cucullia_absinthii	Noctuidae_non-Noctuinae
Deltote_deceptoria	Noctuidae_non-Noctuinae
Euchalcia_consona	Noctuidae_non-Noctuinae
Cucullia_campanulae	Noctuidae_non-Noctuinae
Condica_capensis	Noctuidae_non-Noctuinae
Acronicta_psi	Noctuidae_non-Noctuinae
Cucullia_fraudatrix	Noctuidae_non-Noctuinae
Bryophila_domestica	Noctuidae_non-Noctuinae
Xylocampa_areola	Noctuidae_non-Noctuinae
Recoropha_canteneri	Noctuidae_non-Noctuinae
Calophasia_opalina	Noctuidae_non-Noctuinae
Bryonycta_opulenta	Noctuidae_non-Noctuinae
Cucullia_calendulae	Noctuidae_non-Noctuinae
Euchalcia_modestoides	Noctuidae_non-Noctuinae
Syngrapha_devergens	Noctuidae_non-Noctuinae
Shargacucullia_prenanthis	Noctuidae_non-Noctuinae
Heliothis_ononis	Noctuidae_non-Noctuinae
Euchalcia_bellieri	Noctuidae_non-Noctuinae
Teinoptera_olivina	Noctuidae_non-Noctuinae
Acronicta_cinerea	Noctuidae_non-Noctuinae
Chrysodeixis_chalcites	Noctuidae_non-Noctuinae
Shargacucullia_verbasci	Noctuidae_non-Noctuinae
Xanthodes_albago	Noctuidae_non-Noctuinae
Bryophila_gea	Noctuidae_non-Noctuinae
Cucullia_balsamitae	Noctuidae_non-Noctuinae
Helicoverpa_armigera	Noctuidae_non-Noctuinae
Heliothis_viriplaca	Noctuidae_non-Noctuinae
Cornutiplusia_circumflexa	Noctuidae_non-Noctuinae
Acontia_trabealis	Noctuidae_non-Noctuinae
Heliothis_adaucta	Noctuidae_non-Noctuinae
Colocasia_coryli	Noctuidae_non-Noctuinae
Pyrrhia_exprimens	Noctuidae_non-Noctuinae
Thysanoplusia_daubei	Noctuidae_non-Noctuinae
Amephana_anarrhini	Noctuidae_non-Noctuinae
Abrostola_asclepiadis	Noctuidae_non-Noctuinae
Eucarta_virgo	Noctuidae_non-Noctuinae
Cucullia_formosa	Noctuidae_non-Noctuinae
Stilbia_andalusiaca	Noctuidae_non-Noctuinae
Autographa_macrogamma	Noctuidae_non-Noctuinae
Craniophora_ligustri	Noctuidae_non-Noctuinae
Autographa_buraetica	Noctuidae_non-Noctuinae
Deltote_pygarga	Noctuidae_non-Noctuinae
Calophasia_platyptera	Noctuidae_non-Noctuinae
Acronicta_alni	Noctuidae_non-Noctuinae
Acontia_lucida	Noctuidae_non-Noctuinae
Panchrysia_deaurata	Noctuidae_non-Noctuinae
Schinia_cardui	Noctuidae_non-Noctuinae
Allophyes_corsica	Noctuidae_non-Noctuinae
Haemerosia_renalis	Noctuidae_non-Noctuinae
Shargacucullia_blattariae	Noctuidae_non-Noctuinae
Diachrysia_stenochrysis	Noctuidae_non-Noctuinae
Aedia_leucomelas	Noctuidae_non-Noctuinae
Cryphia_ochsi	Noctuidae_non-Noctuinae
Amphipyra_effusa	Noctuidae_non-Noctuinae
Geractia_poliotis	Noctuidae_non-Noctuinae
Deltote_bankiana	Noctuidae_non-Noctuinae
Pardoxia_graellsi	Noctuidae_non-Noctuinae
Panchrysia_vargenteum	Noctuidae_non-Noctuinae
Aedia_funesta	Noctuidae_non-Noctuinae
Periphanes_delphinii	Noctuidae_non-Noctuinae
Cucullia_umbratica	Noctuidae_non-Noctuinae
Syngrapha_hochenwarthi	Noctuidae_non-Noctuinae
Amphipyra_perflua	Noctuidae_non-Noctuinae
Acronicta_leporina	Noctuidae_non-Noctuinae
Syngrapha_microgamma	Noctuidae_non-Noctuinae
Acronicta_tridens	Noctuidae_non-Noctuinae
Cucullia_dracunculi	Noctuidae_non-Noctuinae
Eucarta_amethystina	Noctuidae_non-Noctuinae
Deltote_incognita	Noctuidae_non-Noctuinae
Cucullia_tanaceti	Noctuidae_non-Noctuinae
Omia_cymbalariae	Noctuidae_non-Noctuinae
Sympistis_funebris	Noctuidae_non-Noctuinae
Allophyes_oxyacanthae	Noctuidae_non-Noctuinae
Amphipyra_tragopoginis	Noctuidae_non-Noctuinae
Cucullia_artemisiae	Noctuidae_non-Noctuinae
Cleonymia_yvanii	Noctuidae_non-Noctuinae
Callopistria_latreillei	Noctuidae_non-Noctuinae
Meganephria_bimaculosa	Noctuidae_non-Noctuinae
Epimecia_ustula	Noctuidae_non-Noctuinae
Cucullia_lucifuga	Noctuidae_non-Noctuinae
Acronicta_rumicis	Noctuidae_non-Noctuinae
Valeria_oleagina	Noctuidae_non-Noctuinae
Shargacucullia_lychnitis	Noctuidae_non-Noctuinae
Euchalcia_italica	Noctuidae_non-Noctuinae
Heliothis_maritima	Noctuidae_non-Noctuinae
Autographa_excelsa	Noctuidae_non-Noctuinae
Nycteola_columbana	Nolidae
Nycteola_revayana	Nolidae
Earias_vernana	Nolidae
Earias_clorana	Nolidae
Bena_bicolorana	Nolidae
Pseudoips_prasinana	Nolidae
Meganola_togatulalis	Nolidae
Nola_karelica	Nolidae
Nycteola_degenerana	Nolidae
Nycteola_asiatica	Nolidae
Meganola_gigantula	Nolidae
Meganola_strigula	Nolidae
Meganola_albula	Nolidae
Nola_thymula	Nolidae
Nola_squalida	Nolidae
Nola_dresnayi	Nolidae
Nola_aerugula	Nolidae
Nola_chlamitulalis	Nolidae
Nola_infantula	Nolidae
Nola_cristatula	Nolidae
Nola_subchlamydula	Nolidae
Nola_cucullatella	Nolidae
Nola_confusalis	Nolidae
Harpyia_milhauseri	Notodontidae
Pygaera_timon	Notodontidae
Thaumetopoea_pityocampa	Notodontidae
Thaumetopoea_processionea	Notodontidae
Furcula_furcula	Notodontidae
Furcula_bifida	Notodontidae
Furcula_bicuspis	Notodontidae
Cerura_erminea	Notodontidae
Phalera_bucephaloides	Notodontidae
Phalera_bucephala	Notodontidae
Spatalia_argentina	Notodontidae
Pterostoma_palpina	Notodontidae
Gluphisia_crenata	Notodontidae
Cerura_delavoiei	Notodontidae
Ptilophora_plumigera	Notodontidae
Clostera_anastomosis	Notodontidae
Cerura_vinula	Notodontidae
Cerura_iberica	Notodontidae
Cerura_intermedia	Notodontidae
Odontosia_sieversii	Notodontidae
Odontosia_carmelita	Notodontidae
Leucodonta_bicoloria	Notodontidae
Clostera_anachoreta	Notodontidae
Ptilodon_cucullina	Notodontidae
Ptilodon_capucina	Notodontidae
Stauropus_fagi	Notodontidae
Clostera_curtula	Notodontidae
Clostera_pigra	Notodontidae
Pheosia_gnoma	Notodontidae
Pheosia_tremula	Notodontidae
Drymonia_velitaris	Notodontidae
Notodonta_tritophus	Notodontidae
Notodonta_dromedarius	Notodontidae
Notodonta_ziczac	Notodontidae
Notodonta_torva	Notodontidae
Drymonia_obliterata	Notodontidae
Drymonia_querna	Notodontidae
Drymonia_ruficornis	Notodontidae
Peridea_anceps	Notodontidae
Drymonia_dodonaea	Notodontidae
Neptis_sappho	Nymphalidae
Neptis_rivularis	Nymphalidae
Limenitis_reducta	Nymphalidae
Limenitis_populi	Nymphalidae
Limenitis_camilla	Nymphalidae
Apatura_iris	Nymphalidae
Araschnia_levana	Nymphalidae
Libythea_celtis	Nymphalidae
Apatura_metis	Nymphalidae
Apatura_ilia	Nymphalidae
Lasiommata_maera	Nymphalidae
Hyponephele_lycaon	Nymphalidae
Boloria_frigga	Nymphalidae
Boloria_improba	Nymphalidae
Boloria_dia	Nymphalidae
Boloria_eunomia	Nymphalidae
Aglais_urticae	Nymphalidae
Vanessa_cardui	Nymphalidae
Vanessa_atalanta	Nymphalidae
Euphydryas_aurinia	Nymphalidae
Kirinia_roxelana	Nymphalidae
Lopinga_achine	Nymphalidae
Pararge_xiphia	Nymphalidae
Pararge_aegeria	Nymphalidae
Lasiommata_petropolitana	Nymphalidae
Lasiommata_megera	Nymphalidae
Argynnis_aglaja	Nymphalidae
Issoria_lathonia	Nymphalidae
Boloria_graeca	Nymphalidae
Aglais_io	Nymphalidae
Euphydryas_cynthia	Nymphalidae
Melitaea_cinxia	Nymphalidae
Coenonympha_glycerion	Nymphalidae
Coenonympha_oedippus	Nymphalidae
Coenonympha_pamphilus	Nymphalidae
Minois_dryas	Nymphalidae
Oeneis_bore	Nymphalidae
Maniola_jurtina	Nymphalidae
Boloria_selene	Nymphalidae
Boloria_thore	Nymphalidae
Boloria_polaris	Nymphalidae
Brenthis_hecate	Nymphalidae
Boloria_pales	Nymphalidae
Euphydryas_iduna	Nymphalidae
Euphydryas_maturna	Nymphalidae
Melitaea_britomartis	Nymphalidae
Melitaea_athalia	Nymphalidae
Melitaea_diamina	Nymphalidae
Melitaea_didyma	Nymphalidae
Oeneis_glacialis	Nymphalidae
Oeneis_norna	Nymphalidae
Oeneis_jutta	Nymphalidae
Erebia_oeme	Nymphalidae
Aphantopus_hyperantus	Nymphalidae
Argynnis_paphia	Nymphalidae
Argynnis_pandora	Nymphalidae
Argynnis_laodice	Nymphalidae
Brenthis_daphne	Nymphalidae
Brenthis_ino	Nymphalidae
Boloria_napaea	Nymphalidae
Boloria_aquilonaris	Nymphalidae
Polygonia_egea	Nymphalidae
Polygonia_calbum	Nymphalidae
Nymphalis_vaualbum	Nymphalidae
Melitaea_parthenoides	Nymphalidae
Melitaea_trivia	Nymphalidae
Melitaea_phoebe	Nymphalidae
Coenonympha_rhodopensis	Nymphalidae
Coenonympha_tullia	Nymphalidae
Coenonympha_hero	Nymphalidae
Brintesia_circe	Nymphalidae
Chazara_briseis	Nymphalidae
Erebia_embla	Nymphalidae
Erebia_disa	Nymphalidae
Erebia_medusa	Nymphalidae
Erebia_polaris	Nymphalidae
Pyronia_tithonus	Nymphalidae
Pyronia_cecilia	Nymphalidae
Boloria_chariclea	Nymphalidae
Boloria_titania	Nymphalidae
Boloria_euphrosyne	Nymphalidae
Boloria_freija	Nymphalidae
Argynnis_adippe	Nymphalidae
Argynnis_niobe	Nymphalidae
Nymphalis_polychloros	Nymphalidae
Melitaea_varia	Nymphalidae
Coenonympha_gardetta	Nymphalidae
Coenonympha_leander	Nymphalidae
Coenonympha_arcania	Nymphalidae
Arethusana_arethusa	Nymphalidae
Melanargia_galathea	Nymphalidae
Hipparchia_statilinus	Nymphalidae
Erebia_manto	Nymphalidae
Nymphalis_antiopa	Nymphalidae
Nymphalis_xanthomelas	Nymphalidae
Melitaea_aurelia	Nymphalidae
Melitaea_asteria	Nymphalidae
Erebia_ottomana	Nymphalidae
Hipparchia_hermione	Nymphalidae
Hipparchia_alcyone	Nymphalidae
Hipparchia_fagi	Nymphalidae
Hipparchia_syriaca	Nymphalidae
Hipparchia_senthes	Nymphalidae
Hipparchia_volgensis	Nymphalidae
Hipparchia_semele	Nymphalidae
Erebia_gorge	Nymphalidae
Erebia_aethiops	Nymphalidae
Erebia_styx	Nymphalidae
Erebia_eriphyle	Nymphalidae
Erebia_tyndarus	Nymphalidae
Erebia_cassioides	Nymphalidae
Erebia_nivalis	Nymphalidae
Erebia_meolans	Nymphalidae
Erebia_alberganus	Nymphalidae
Erebia_euryale	Nymphalidae
Erebia_ligea	Nymphalidae
Erebia_sudetica	Nymphalidae
Erebia_melampus	Nymphalidae
Erebia_epiphron	Nymphalidae
Erebia_pharte	Nymphalidae
Erebia_neoridas	Nymphalidae
Erebia_aethiopellus	Nymphalidae
Erebia_mnestra	Nymphalidae
Erebia_pluto	Nymphalidae
Erebia_pandrose	Nymphalidae
Erebia_melas	Nymphalidae
Erebia_pronoe	Nymphalidae
Minetia_crinitus	Oecophoridae
Minetia_criella	Oecophoridae
Esperia_sulphurella	Oecophoridae
Pleurota_punctella	Oecophoridae
Pleurota_aristella	Oecophoridae
Hofmannophila_pseudospretella	Oecophoridae
Tachystola_acroxantha	Oecophoridae
Holoscolia_huebneri	Oecophoridae
Aplota_nigricans	Oecophoridae
Pleurota_bicostella	Oecophoridae
Goidanichiana_jourdheuillella	Oecophoridae
Bisigna_procerella	Oecophoridae
Endrosis_sarcitrella	Oecophoridae
Stathmopoda_pedella	Oecophoridae
Pleurota_pungitiella	Oecophoridae
Aplota_palpella	Oecophoridae
Borkhausenia_luridicomella	Oecophoridae
Neomariania_partinicensis	Oecophoridae
Decantha_borkhausenii	Oecophoridae
Crassa_unitella	Oecophoridae
Harpella_forficella	Oecophoridae
Herrichia_excelsella	Oecophoridae
Borkhausenia_minutella	Oecophoridae
Borkhausenia_fuscescens	Oecophoridae
Orophia_ferrugella	Oecophoridae
Epicallima_formosella	Oecophoridae
Carcina_quercana	Oecophoridae
Alabonia_geoffrella	Oecophoridae
Oecophora_bractella	Oecophoridae
Crassa_tinctella	Oecophoridae
Orophia_mendosella	Oecophoridae
Denisia_luticiliella	Oecophoridae
Batia_internella	Oecophoridae
Batia_lambdella	Oecophoridae
Orophia_denisella	Oecophoridae
Metalampra_cinnamomea	Oecophoridae
Metalampra_italica	Oecophoridae
Denisia_stroemella	Oecophoridae
Schiffermuelleria_schaefferella	Oecophoridae
Orophia_sordidella	Oecophoridae
Orophia_zernyi	Oecophoridae
Denisia_subaquilea	Oecophoridae
Denisia_nubilosella	Oecophoridae
Denisia_fuscicapitella	Oecophoridae
Denisia_obscurella	Oecophoridae
Denisia_similella	Oecophoridae
Denisia_stipella	Oecophoridae
Denisia_rhaetica	Oecophoridae
Iphiclides_podalirius	Papilionidae
Papilio_machaon	Papilionidae
Parnassius_mnemosyne	Papilionidae
Allancastria_cerisyi	Papilionidae
Zerynthia_polyxena	Papilionidae
Parnassius_phoebus	Papilionidae
Parnassius_apollo	Papilionidae
Leptidea_morsei	Pieridae
Aporia_crataegi	Pieridae
Pieris_brassicae	Pieridae
Leptidea_juvernica	Pieridae
Leptidea_sinapis	Pieridae
Colias_tyche	Pieridae
Colias_chrysotheme	Pieridae
Colias_palaeno	Pieridae
Colias_phicomone	Pieridae
Colias_croceus	Pieridae
Colias_hecla	Pieridae
Colias_erate	Pieridae
Colias_hyale	Pieridae
Colias_myrmidone	Pieridae
Colias_alfacariensis	Pieridae
Gonepteryx_cleopatra	Pieridae
Gonepteryx_rhamni	Pieridae
Zegris_eupheme	Pieridae
Euchloe_tagis	Pieridae
Pontia_callidice	Pieridae
Anthocharis_cardamines	Pieridae
Pieris_napi	Pieridae
Pieris_ergane	Pieridae
Pieris_bryoniae	Pieridae
Pieris_mannii	Pieridae
Pieris_rapae	Pieridae
Pontia_edusa	Pieridae
Pontia_daplidice	Pieridae
Euchloe_ausonia	Pieridae
Euchloe_simplonia	Pieridae
Digitivalva_pappella	Plutellidae
Digitivalva_reticulella	Plutellidae
Acrolepia_autumnitella	Plutellidae
Eidophasia_syenitella	Plutellidae
Digitivalva_pulicariae	Plutellidae
Digitivalva_granitella	Plutellidae
Digitivalva_arnicella	Plutellidae
Acrolepiopsis_vesperella	Plutellidae
Acrolepiopsis_assectella	Plutellidae
Rhigognostis_wolfschlaegeri	Plutellidae
Rhigognostis_annulatella	Plutellidae
Rhigognostis_senilella	Plutellidae
Plutella_porrectella	Plutellidae
Eidophasia_messingiella	Plutellidae
Plutella_xylostella	Plutellidae
Rhigognostis_kuusamoensis	Plutellidae
Rhigognostis_incarnatella	Plutellidae
Rhigognostis_schmaltzella	Plutellidae
Plutella_huemerella	Plutellidae
Plutella_geniatella	Plutellidae
Plutella_hyperboreella	Plutellidae
Plutella_haasi	Plutellidae
Lampronia_rupella	Prodoxidae
Lampronia_capitella	Prodoxidae
Lampronia_fuscatella	Prodoxidae
Lampronia_corticella	Prodoxidae
Lampronia_flavimitrella	Prodoxidae
Lampronia_luzella	Prodoxidae
Lampronia_morosa	Prodoxidae
Lampronia_provectella	Prodoxidae
Lampronia_standfussiella	Prodoxidae
Placodoma_calpella	Psychidae
Sciopetris_melitensis	Psychidae
Eumasia_parietariella	Psychidae
Bacotia_claustrella	Psychidae
Narycia_duplicella	Psychidae
Typhonia_beatricis	Psychidae
Luffia_lapidella	Psychidae
Luffia_ferchaultella	Psychidae
Bankesia_montanella	Psychidae
Bankesia_conspurcatella	Psychidae
Diplodoma_laichartingella	Psychidae
Brevantennia_adriatica	Psychidae
Typhonia_pliginskii	Psychidae
Typhonia_ciliaris	Psychidae
Penestoglossa_dardoinella	Psychidae
Pseudobankesia_casaella	Psychidae
Pseudobankesia_vernella	Psychidae
Taleporia_defoliella	Psychidae
Postsolenobia_thomanni	Psychidae
Dahlica_triquetrella	Psychidae
Stichobasis_postmeridianus	Psychidae
Acanthopsyche_ecksteini	Psychidae
Canephora_hirsuta	Psychidae
Pachythelia_villosella	Psychidae
Amicta_cabrerai	Psychidae
Oiketicoides_febretta	Psychidae
Taleporia_politella	Psychidae
Taleporia_borealis	Psychidae
Taleporia_tubulosa	Psychidae
Brevantennia_styriaca	Psychidae
Postsolenobia_nanosella	Psychidae
Postsolenobia_juliella	Psychidae
Psychidea_nudella	Psychidae
Anaproutia_comitella	Psychidae
Anaproutia_reticulatella	Psychidae
Acanthopsyche_atra	Psychidae
Acanthopsyche_zelleri	Psychidae
Oiketicoides_lutea	Psychidae
Ptilocephala_kahri	Psychidae
Brevantennia_triglavensis	Psychidae
Brevantennia_reliqua	Psychidae
Rebelia_styriaca	Psychidae
Bijugis_pectinella	Psychidae
Bijugis_bombycella	Psychidae
Phalacropterix_apiformis	Psychidae
Rebelia_herrichiella	Psychidae
Whittleia_retiella	Psychidae
Ptilocephala_colossa	Psychidae
Rebelia_sapho	Psychidae
Rebelia_bavarica	Psychidae
Proutia_rotunda	Psychidae
Proutia_betulina	Psychidae
Epichnopterix_alpina	Psychidae
Epichnopterix_kovacsi	Psychidae
Epichnopterix_sieboldi	Psychidae
Epichnopterix_plumella	Psychidae
Epichnopterix_montana	Psychidae
Ptilocephala_agrostidis	Psychidae
Ptilocephala_plumifera	Psychidae
Ptilocephala_muscella	Psychidae
Oreopsyche_tenella	Psychidae
Leptopterix_hirsutella	Psychidae
Ptilocephala_albida	Psychidae
Ptilocephala_wockei	Psychidae
Ptilocephala_pyrenaella	Psychidae
Ptilocephala_matthesi	Psychidae
Megalophanes_turatii	Psychidae
Megalophanes_viciella	Psychidae
Megalophanes_stetinensis	Psychidae
Psyche_casta	Psychidae
Psyche_crassiorella	Psychidae
Anaproutia_norvegica	Psychidae
Anaproutia_raiblensis	Psychidae
Phalacropterix_fritschi	Psychidae
Sterrhopterix_standfussi	Psychidae
Sterrhopterix_fusca	Psychidae
Phalacropterix_graslinella	Psychidae
Phalacropterix_praecellens	Psychidae
Emmelina_monodactyla	Pterophoridae
Porrittia_galactodactyla	Pterophoridae
Hellinsia_lienigianus	Pterophoridae
Oidaematophorus_rogenhoferi	Pterophoridae
Hellinsia_tephradactyla	Pterophoridae
Pselnophorus_heterodactyla	Pterophoridae
Crombrugghia_laetus	Pterophoridae
Crombrugghia_tristis	Pterophoridae
Crombrugghia_distans	Pterophoridae
Crombrugghia_propedistans	Pterophoridae
Crombrugghia_kollari	Pterophoridae
Crombrugghia_jaeckhi	Pterophoridae
Crombrugghia_buvati	Pterophoridae
Oxyptilus_chrysodactyla	Pterophoridae
Oxyptilus_ericetorum	Pterophoridae
Oidaematophorus_vafradactylus	Pterophoridae
Pterophorus_pentadactyla	Pterophoridae
Amblyptilia_punctidactyla	Pterophoridae
Amblyptilia_acanthadactyla	Pterophoridae
Stenoptilodes_taprobanes	Pterophoridae
Cnaemidophorus_rhododactyla	Pterophoridae
Oxyptilus_pilosellae	Pterophoridae
Oxyptilus_parvidactyla	Pterophoridae
Oidaematophorus_giganteus	Pterophoridae
Oidaematophorus_lithodactyla	Pterophoridae
Wheeleria_spilodactylus	Pterophoridae
Buszkoiana_capnodactylus	Pterophoridae
Stangeia_siceliota	Pterophoridae
Marasmarcha_lunaedactyla	Pterophoridae
Agdistis_bennetii	Pterophoridae
Agdistis_meridionalis	Pterophoridae
Agdistis_neglecta	Pterophoridae
Calyciphora_albodactylus	Pterophoridae
Calyciphora_nephelodactyla	Pterophoridae
Merrifieldia_leucodactyla	Pterophoridae
Stenoptilia_mimula	Pterophoridae
Stenoptilia_zophodactylus	Pterophoridae
Capperia_britanniodactylus	Pterophoridae
Geina_didactyla	Pterophoridae
Buckleria_paludum	Pterophoridae
Agdistis_adactyla	Pterophoridae
Agdistis_satanas	Pterophoridae
Puerphorus_olbiadactylus	Pterophoridae
Gypsochares_bigoti	Pterophoridae
Merrifieldia_tridactyla	Pterophoridae
Gillmeria_ochrodactyla	Pterophoridae
Platyptilia_gonodactyla	Pterophoridae
Platyptilia_nemoralis	Pterophoridae
Platyptilia_tesseradactyla	Pterophoridae
Platyptilia_calodactyla	Pterophoridae
Capperia_trichodactyla	Pterophoridae
Capperia_celeusi	Pterophoridae
Adaina_microdactyla	Pterophoridae
Merrifieldia_baliodactylus	Pterophoridae
Gillmeria_miantodactylus	Pterophoridae
Gillmeria_pallidactyla	Pterophoridae
Stenoptilia_annadactyla	Pterophoridae
Stenoptilia_bipunctidactyla	Pterophoridae
Stenoptilia_lutescens	Pterophoridae
Stenoptilia_graphodactyla	Pterophoridae
Stenoptilia_pneumonanthes	Pterophoridae
Hellinsia_alpinus	Pterophoridae
Hellinsia_carphodactyla	Pterophoridae
Hellinsia_pectodactylus	Pterophoridae
Hellinsia_didactylites	Pterophoridae
Hellinsia_distinctus	Pterophoridae
Merrifieldia_bystropogonis	Pterophoridae
Merrifieldia_malacodactyla	Pterophoridae
Stenoptilia_pelidnodactyla	Pterophoridae
Stenoptilia_veronicae	Pterophoridae
Stenoptilia_nolckeni	Pterophoridae
Stenoptilia_coprodactylus	Pterophoridae
Hellinsia_osteodactylus	Pterophoridae
Stenoptilia_bigoti	Pterophoridae
Stenoptilia_pterodactyla	Pterophoridae
Hellinsia_chrysocomae	Pterophoridae
Hellinsia_cinerariae	Pterophoridae
Stenoptilia_buvati	Pterophoridae
Stenoptilia_stigmatodactylus	Pterophoridae
Stenoptilia_stigmatodactyla	Pterophoridae
Stenoptilia_alpinalis	Pterophoridae
Stenoptilia_mercantourica	Pterophoridae
Stenoptilia_brigantiensis	Pterophoridae
Stenoptilia_islandicus	Pterophoridae
Synaphe_punctalis	Pyralidae
Endotricha_flammealis	Pyralidae
Synaphe_antennalis	Pyralidae
Stemmatophora_brunnealis	Pyralidae
Aglossa_pinguinalis	Pyralidae
Aphomia_zelleri	Pyralidae
Aphomia_sociella	Pyralidae
Galleria_mellonella	Pyralidae
Achroia_grisella	Pyralidae
Pyralis_regalis	Pyralidae
Hypsopygia_costalis	Pyralidae
Nephopterix_angustella	Pyralidae
Etiella_zinckenella	Pyralidae
Pyralis_lienigialis	Pyralidae
Pyralis_farinalis	Pyralidae
Hypsopygia_glaucinalis	Pyralidae
Hypsopygia_rubidalis	Pyralidae
Acrobasis_glaucella	Pyralidae
Acrobasis_sodalella	Pyralidae
Acrobasis_consociella	Pyralidae
Ancylosis_cinnamomella	Pyralidae
Apomyelois_bistriatella	Pyralidae
Assara_terebrella	Pyralidae
Euzophera_fuliginosella	Pyralidae
Nyctegretis_lineana	Pyralidae
Euzophera_bigella	Pyralidae
Acrobasis_advenella	Pyralidae
Acrobasis_suavella	Pyralidae
Acrobasis_marmorea	Pyralidae
Merulempista_cingillella	Pyralidae
Oncocera_semirubella	Pyralidae
Eccopisa_effractella	Pyralidae
Glyptoteles_leucacrinella	Pyralidae
Euzophera_cinerosella	Pyralidae
Euzophera_pinguis	Pyralidae
Zophodia_grossulariella	Pyralidae
Homoeosoma_sinuella	Pyralidae
Eurhodope_rosella	Pyralidae
Vitula_edmandsii	Pyralidae
Myelois_circumvoluta	Pyralidae
Episcythrastis_tetricella	Pyralidae
Homoeosoma_nimbella	Pyralidae
Homoeosoma_nebulella	Pyralidae
Phycitodes_maritima	Pyralidae
Phycitodes_albatella	Pyralidae
Phycitodes_lacteella	Pyralidae
Acrobasis_obtusella	Pyralidae
Acrobasis_legatea	Pyralidae
Acrobasis_repandana	Pyralidae
Acrobasis_tumidana	Pyralidae
Pima_boisduvaliella	Pyralidae
Eurhodope_incompta	Pyralidae
Eurhodope_cirrigerella	Pyralidae
Phycitodes_saxicola	Pyralidae
Phycitodes_binaevella	Pyralidae
Anerastia_lotella	Pyralidae
Rhodophaea_formosa	Pyralidae
Elegia_similella	Pyralidae
Asartodes_monspesulalis	Pyralidae
Bradyrrhoa_gilveolella	Pyralidae
Megasis_rippertella	Pyralidae
Cremnophila_sedakovella	Pyralidae
Polopeustis_altensis	Pyralidae
Ephestia_kuehniella	Pyralidae
Vitula_biviella	Pyralidae
Plodia_interpunctella	Pyralidae
Phycita_roborella	Pyralidae
Khorassania_compositella	Pyralidae
Catastia_kistrandella	Pyralidae
Catastia_marginea	Pyralidae
Salebriopsis_albicilla	Pyralidae
Asarta_aethiopella	Pyralidae
Asarta_alpicolella	Pyralidae
Cadra_cautella	Pyralidae
Hypochalcia_ahenella	Pyralidae
Hypochalcia_lignella	Pyralidae
Pempelia_palumbella	Pyralidae
Psorosa_nucleolella	Pyralidae
Selagia_spadicella	Pyralidae
Ephestia_welseriella	Pyralidae
Pempelia_alpigenella	Pyralidae
Pempelia_genistella	Pyralidae
Ortholepis_betulae	Pyralidae
Ortholepis_vacciniella	Pyralidae
Selagia_argyrella	Pyralidae
Matilella_fusca	Pyralidae
Sciota_lucipetella	Pyralidae
Ephestia_elutella	Pyralidae
Cryptoblabes_bistriga	Pyralidae
Laodamia_faecella	Pyralidae
Sciota_adelphella	Pyralidae
Ephestia_parasitella	Pyralidae
Ephestia_mistralella	Pyralidae
Ephestia_unicolorella	Pyralidae
Moitrelia_obductella	Pyralidae
Dioryctria_sylvestrella	Pyralidae
Sciota_fumella	Pyralidae
Pempeliella_ornatella	Pyralidae
Delplanqueia_dilutella	Pyralidae
Dioryctria_schuetzeella	Pyralidae
Sciota_rhenella	Pyralidae
Sciota_hostilis	Pyralidae
Dioryctria_abietella	Pyralidae
Dioryctria_simplicella	Pyralidae
Dioryctria_mendacella	Pyralidae
Dioryctria_pineae	Pyralidae
Scythris_penicillata	Scythrididae
Scythris_fuscopterella	Scythrididae
Scythris_noricella	Scythrididae
Scythris_inspersella	Scythrididae
Scythris_subsiccella	Scythrididae
Scythris_lempkei	Scythrididae
Scythris_empetrella	Scythrididae
Scythris_antisymmetrica	Scythrididae
Scythris_mus	Scythrididae
Scythris_ericivorella	Scythrididae
Scythris_ridiculella	Scythrididae
Enolmis_acanthella	Scythrididae
Scythris_inertella	Scythrididae
Scythris_disparella	Scythrididae
Scythris_picaepennis	Scythrididae
Scythris_lhommei	Scythrididae
Scythris_scopolella	Scythrididae
Scythris_cistorum	Scythrididae
Scythris_crassiuscula	Scythrididae
Scythris_fuscoaenea	Scythrididae
Scythris_oelandicella	Scythrididae
Scythris_sappadensis	Scythrididae
Scythris_fallacella	Scythrididae
Scythris_grandipennis	Scythrididae
Scythris_ericetella	Scythrididae
Scythris_dorycniella	Scythrididae
Scythris_tergestinella	Scythrididae
Scythris_subseliniella	Scythrididae
Parascythris_muelleri	Scythrididae
Scythris_vartianae	Scythrididae
Scythris_vittella	Scythrididae
Scythris_dissimilella	Scythrididae
Scythris_seliniella	Scythrididae
Scythris_clavella	Scythrididae
Scythris_palustris	Scythrididae
Scythris_productella	Scythrididae
Scythris_limbella	Scythrididae
Scythris_flavidella	Scythrididae
Scythris_laminella	Scythrididae
Scythris_tributella	Scythrididae
Scythris_emichi	Scythrididae
Scythris_punctivittella	Scythrididae
Scythris_glacialis	Scythrididae
Scythris_similis	Scythrididae
Scythris_ventosella	Scythrididae
Scythris_hornigii	Scythrididae
Scythris_speyeri	Scythrididae
Scythris_cuspidella	Scythrididae
Scythris_obscurella	Scythrididae
Scythris_amphonycella	Scythrididae
Scythris_flavilaterella	Scythrididae
Scythris_knochella	Scythrididae
Scythris_heinemanni	Scythrididae
Scythris_cicadella	Scythrididae
Scythris_potentillella	Scythrididae
Paranthrene_insolitus	Sesiidae
Paranthrene_tabaniformis	Sesiidae
Sesia_melanocephala	Sesiidae
Sesia_apiformis	Sesiidae
Sesia_bembeciformis	Sesiidae
Pennisetia_hylaeiformis	Sesiidae
Chamaesphecia_empiformis	Sesiidae
Bembecia_ichneumoniformis	Sesiidae
Synanthedon_flaviventris	Sesiidae
Synanthedon_polaris	Sesiidae
Pyropteron_muscaeformis	Sesiidae
Synanthedon_culiciformis	Sesiidae
Synanthedon_formicaeformis	Sesiidae
Pyropteron_affinis	Sesiidae
Pyropteron_triannuliformis	Sesiidae
Synanthedon_andrenaeformis	Sesiidae
Synanthedon_soffneri	Sesiidae
Synanthedon_myopaeformis	Sesiidae
Synanthedon_stomoxiformis	Sesiidae
Synanthedon_spheciformis	Sesiidae
Synanthedon_mesiaeformis	Sesiidae
Synanthedon_scoliaeformis	Sesiidae
Synanthedon_cephiformis	Sesiidae
Synanthedon_tipuliformis	Sesiidae
Daphnis_nerii	Sphingidae
Macroglossum_stellatarum	Sphingidae
Hemaris_tityus	Sphingidae
Hemaris_fuciformis	Sphingidae
Proserpinus_proserpina	Sphingidae
Hyles_livornica	Sphingidae
Deilephila_elpenor	Sphingidae
Deilephila_porcellus	Sphingidae
Acherontia_atropos	Sphingidae
Mimas_tiliae	Sphingidae
Hyles_gallii	Sphingidae
Agrius_convolvuli	Sphingidae
Smerinthus_ocellata	Sphingidae
Hyles_vespertilio	Sphingidae
Sphinx_ligustri	Sphingidae
Laothoe_amurensis	Sphingidae
Laothoe_populi	Sphingidae
Hyles_hippophaes	Sphingidae
Hyles_dahlii	Sphingidae
Hyles_sammuti	Sphingidae
Hyles_euphorbiae	Sphingidae
Hyles_cretica	Sphingidae
Sphinx_maurorum	Sphingidae
Sphinx_pinastri	Sphingidae
Dasypteroma_thaumasia	Sterrhinae
Cyclophora_puppillaria	Sterrhinae
Rhodostrophia_vibicaria	Sterrhinae
Timandra_comae	Sterrhinae
Timandra_griseata	Sterrhinae
Rhodometra_sacraria	Sterrhinae
Casilda_antophilaria	Sterrhinae
Cyclophora_porata	Sterrhinae
Cinglis_andalusiaria	Sterrhinae
Rhodostrophia_pudorata	Sterrhinae
Cyclophora_ruficiliaria	Sterrhinae
Scopula_nemoraria	Sterrhinae
Rhodostrophia_cretacaria	Sterrhinae
Idaea_attenuaria	Sterrhinae
Idaea_incalcarata	Sterrhinae
Oar_reaumuraria	Sterrhinae
Scopula_corrivalaria	Sterrhinae
Scopula_ornata	Sterrhinae
Rhodostrophia_calabra	Sterrhinae
Rhodostrophia_tabidaria	Sterrhinae
Cyclophora_annularia	Sterrhinae
Cyclophora_linearia	Sterrhinae
Idaea_troglodytaria	Sterrhinae
Idaea_filicata	Sterrhinae
Scopula_virgulata	Sterrhinae
Scopula_minorata	Sterrhinae
Scopula_decorata	Sterrhinae
Cyclophora_lennigiaria	Sterrhinae
Cyclophora_pendularia	Sterrhinae
Scopula_vigilata	Sterrhinae
Scopula_submutata	Sterrhinae
Cyclophora_albiocellaria	Sterrhinae
Cyclophora_ariadne	Sterrhinae
Cyclophora_albipunctata	Sterrhinae
Idaea_typicata	Sterrhinae
Idaea_urcitana	Sterrhinae
Idaea_alyssumata	Sterrhinae
Scopula_caricaria	Sterrhinae
Scopula_umbelaria	Sterrhinae
Scopula_nigropunctata	Sterrhinae
Scopula_scalercii	Sterrhinae
Cyclophora_punctaria	Sterrhinae
Cyclophora_suppunctaria	Sterrhinae
Cyclophora_quercimontaria	Sterrhinae
Idaea_alicantaria	Sterrhinae
Idaea_fuscovenosa	Sterrhinae
Idaea_politaria	Sterrhinae
Idaea_efflorata	Sterrhinae
Idaea_blaesii	Sterrhinae
Idaea_inquinata	Sterrhinae
Idaea_deitanaria	Sterrhinae
Idaea_laevigata	Sterrhinae
Scopula_immorata	Sterrhinae
Scopula_tessellaria	Sterrhinae
Scopula_floslactata	Sterrhinae
Scopula_turbulentaria	Sterrhinae
Scopula_marginepunctata	Sterrhinae
Scopula_incanata	Sterrhinae
Idaea_intermedia	Sterrhinae
Idaea_dilutaria	Sterrhinae
Scopula_rubiginata	Sterrhinae
Scopula_ochraceata	Sterrhinae
Idaea_mustelata	Sterrhinae
Idaea_rusticata	Sterrhinae
Idaea_ochrata	Sterrhinae
Idaea_contiguaria	Sterrhinae
Brachyglossina_hispanaria	Sterrhinae
Idaea_degeneraria	Sterrhinae
Idaea_gelbrechti	Sterrhinae
Idaea_biselata	Sterrhinae
Idaea_albarracina	Sterrhinae
Idaea_longaria	Sterrhinae
Idaea_subsericeata	Sterrhinae
Idaea_minuscularia	Sterrhinae
Idaea_albitorquata	Sterrhinae
Idaea_incisaria	Sterrhinae
Idaea_atlantica	Sterrhinae
Idaea_simplicior	Sterrhinae
Idaea_deversaria	Sterrhinae
Idaea_eugeniata	Sterrhinae
Idaea_obliquaria	Sterrhinae
Idaea_rubraria	Sterrhinae
Idaea_subsaturata	Sterrhinae
Idaea_distinctaria	Sterrhinae
Idaea_ostrinaria	Sterrhinae
Idaea_exilaria	Sterrhinae
Idaea_cervantaria	Sterrhinae
Idaea_aversata	Sterrhinae
Idaea_seriata	Sterrhinae
Idaea_pallidata	Sterrhinae
Idaea_predotaria	Sterrhinae
Idaea_camparia	Sterrhinae
Idaea_vesubiata	Sterrhinae
Idaea_metohiensis	Sterrhinae
Idaea_emarginata	Sterrhinae
Idaea_dimidiata	Sterrhinae
Idaea_straminata	Sterrhinae
Idaea_textaria	Sterrhinae
Idaea_trigeminata	Sterrhinae
Idaea_calunetaria	Sterrhinae
Idaea_abnorma	Sterrhinae
Idaea_ibizaria	Sterrhinae
Idaea_davidi	Sterrhinae
Idaea_humiliata	Sterrhinae
Scopula_subpunctaria	Sterrhinae
Scopula_immutata	Sterrhinae
Idaea_rufaria	Sterrhinae
Idaea_consolidata	Sterrhinae
Scopula_irrorata	Sterrhinae
Scopula_guancharia	Sterrhinae
Cleta_filacearia	Sterrhinae
Idaea_mediaria	Sterrhinae
Idaea_leipnitzi	Sterrhinae
Idaea_libycata	Sterrhinae
Idaea_joannisiata	Sterrhinae
Idaea_obsoletaria	Sterrhinae
Idaea_palaestinensis	Sterrhinae
Idaea_fractilineata	Sterrhinae
Scopula_flaccidaria	Sterrhinae
Idaea_flaveolaria	Sterrhinae
Idaea_ossiculata	Sterrhinae
Idaea_consanguinaria	Sterrhinae
Idaea_circuitaria	Sterrhinae
Idaea_rainerii	Sterrhinae
Idaea_elongaria	Sterrhinae
Idaea_palmata	Sterrhinae
Idaea_consanguiberica	Sterrhinae
Idaea_belemiata	Sterrhinae
Idaea_carvalhoi	Sterrhinae
Idaea_moniliata	Sterrhinae
Idaea_infirmaria	Sterrhinae
Scopula_emutaria	Sterrhinae
Scopula_asellaria	Sterrhinae
Scopula_imitaria	Sterrhinae
Scopula_decolor	Sterrhinae
Idaea_serpentata	Sterrhinae
Emmiltis_pygmaearia	Sterrhinae
Idaea_sardoniata	Sterrhinae
Idaea_tineata	Sterrhinae
Idaea_rhodogrammaria	Sterrhinae
Scopula_frigidaria	Sterrhinae
Scopula_ternata	Sterrhinae
Scopula_rufomixtaria	Sterrhinae
Idaea_aureolaria	Sterrhinae
Idaea_determinata	Sterrhinae
Idaea_korbi	Sterrhinae
Idaea_sericeata	Sterrhinae
Scopula_mentzeri	Sterrhinae
Idaea_mutilata	Sterrhinae
Idaea_litigiosaria	Sterrhinae
Idaea_sylvestraria	Sterrhinae
Idaea_muricata	Sterrhinae
Scopula_alba	Sterrhinae
Scopula_confinaria	Sterrhinae
Monopis_fenestratella	Tineidae
Tinea_semifulvella	Tineidae
Tinea_trinotella	Tineidae
Elatobia_fuliginosella	Tineidae
Crassicornella_crassicornella	Tineidae
Tinea_murariella	Tineidae
Anomalotinea_cubiculella	Tineidae
Euplocamus_anthracinalis	Tineidae
Dryadaula_heindeli	Tineidae
Tinea_columbariella	Tineidae
Trichophaga_scandinaviella	Tineidae
Tinea_nonimella	Tineidae
Tinea_basifasciella	Tineidae
Niditinea_striolella	Tineidae
Infurcitinea_argentimaculella	Tineidae
Neurothaumasia_ankerella	Tineidae
Cephimallota_crassiflavella	Tineidae
Triaxomera_parasitella	Tineidae
Triaxomera_fulvimitrella	Tineidae
Scardia_boletella	Tineidae
Tinea_pellionella	Tineidae
Tineola_bisselliella	Tineidae
Tinea_svenssoni	Tineidae
Tinea_bothniella	Tineidae
Tinea_steueri	Tineidae
Monopis_obviella	Tineidae
Monopis_nigricantella	Tineidae
Monopis_imella	Tineidae
Trichophaga_bipartitella	Tineidae
Trichophaga_tapetzella	Tineidae
Niditinea_truncicolella	Tineidae
Niditinea_fuscella	Tineidae
Infurcitinea_atrifasciella	Tineidae
Haplotinea_ditella	Tineidae
Haplotinea_insectella	Tineidae
Morophaga_choragella	Tineidae
Montescardia_tessulatellus	Tineidae
Tinea_dubiella	Tineidae
Tinea_flavescentella	Tineidae
Monopis_crocicapitella	Tineidae
Infurcitinea_finalis	Tineidae
Eudarcia_pagenstecherella	Tineidae
Eudarcia_richardsoni	Tineidae
Cephimallota_tunesiella	Tineidae
Myrmecozela_ochraceella	Tineidae
Opogona_sacchari	Tineidae
Opogona_omoscopa	Tineidae
Hapsifera_luridella	Tineidae
Crassicornella_agenjoi	Tineidae
Psychoides_filicivora	Tineidae
Psychoides_verhuella	Tineidae
Agnathosia_mendicella	Tineidae
Stenoptinea_cyaneimarmorella	Tineidae
Ateliotum_hungaricellum	Tineidae
Ateliotum_petrinella	Tineidae
Nemaxera_betulinella	Tineidae
Nemapogon_clematella	Tineidae
Nemapogon_ruricolella	Tineidae
Monopis_spilotella	Tineidae
Monopis_monachella	Tineidae
Monopis_laevigella	Tineidae
Infurcitinea_captans	Tineidae
Infurcitinea_albanica	Tineidae
Infurcitinea_albicomella	Tineidae
Monopis_neglecta	Tineidae
Monopis_weaverella	Tineidae
Infurcitinea_roesslerella	Tineidae
Infurcitinea_ignicomella	Tineidae
Nemapogon_gravosaellus	Tineidae
Nemapogon_granella	Tineidae
Nemapogon_variatella	Tineidae
Nemapogon_fungivorella	Tineidae
Archinemapogon_yildizae	Tineidae
Nemapogon_inconditella	Tineidae
Nemapogon_nevadella	Tineidae
Nemapogon_nigralbella	Tineidae
Nemapogon_picarella	Tineidae
Nemapogon_cloacella	Tineidae
Nemapogon_wolffiella	Tineidae
Epiblema_graphana	Tortricidae
Epiblema_inulivora	Tortricidae
Eucosma_cana	Tortricidae
Epiblema_simploniana	Tortricidae
Epiblema_sticticana	Tortricidae
Eucosma_balatonana	Tortricidae
Notocelia_rosaecolana	Tortricidae
Epiblema_similana	Tortricidae
Epiblema_foenella	Tortricidae
Eucosma_tripoliana	Tortricidae
Eucosma_aemulana	Tortricidae
Eucosma_saussureana	Tortricidae
Eucosma_conterminana	Tortricidae
Notocelia_roborana	Tortricidae
Epiblema_grandaevana	Tortricidae
Epiblema_scutulana	Tortricidae
Epiblema_cirsiana	Tortricidae
Eucosma_guentheri	Tortricidae
Eucosma_pupillana	Tortricidae
Notocelia_uddmanniana	Tortricidae
Notocelia_cynosbatella	Tortricidae
Notocelia_tetragonana	Tortricidae
Epiblema_turbidana	Tortricidae
Pelochrista_infidana	Tortricidae
Spilonota_laricana	Tortricidae
Spilonota_ocellana	Tortricidae
Eucosma_obumbratana	Tortricidae
Eucosma_flavispecula	Tortricidae
Eucosma_scorzonerana	Tortricidae
Crocidosema_plebejana	Tortricidae
Barbara_herrichiana	Tortricidae
Epinotia_thapsiana	Tortricidae
Dichrorampha_chavanneana	Tortricidae
Dichrorampha_forsteri	Tortricidae
Dichrorampha_sylvicolana	Tortricidae
Dichrorampha_ligulana	Tortricidae
Dichrorampha_agilana	Tortricidae
Dichrorampha_acuminatana	Tortricidae
Dichrorampha_simpliciana	Tortricidae
Dichrorampha_cacaleana	Tortricidae
Dichrorampha_alpinana	Tortricidae
Dichrorampha_alpigenana	Tortricidae
Dichrorampha_montanana	Tortricidae
Dichrorampha_flavidorsana	Tortricidae
Dichrorampha_plumbana	Tortricidae
Dichrorampha_petiverella	Tortricidae
Dichrorampha_dinarica	Tortricidae
Dichrorampha_tarmanni	Tortricidae
Dichrorampha_sedatana	Tortricidae
Dichrorampha_sequana	Tortricidae
Dichrorampha_vancouverana	Tortricidae
Dichrorampha_bugnionana	Tortricidae
Dichrorampha_aeratana	Tortricidae
Dichrorampha_cinerascens	Tortricidae
Dichrorampha_consortana	Tortricidae
Dichrorampha_heegerana	Tortricidae
Notocelia_trimaculana	Tortricidae
Epiblema_costipunctana	Tortricidae
Epiblema_hepaticana	Tortricidae
Grapholita_funebrana	Tortricidae
Eucosma_campoliliana	Tortricidae
Eucosma_suomiana	Tortricidae
Eucosma_messingiana	Tortricidae
Eucosma_albidulana	Tortricidae
Eucosma_lacteana	Tortricidae
Eucosma_fulvana	Tortricidae
Eucosma_hohenwartiana	Tortricidae
Eucosma_parvulana	Tortricidae
Epinotia_abbreviana	Tortricidae
Epinotia_demarniana	Tortricidae
Rhyacionia_maritimana	Tortricidae
Dichrorampha_obscuratana	Tortricidae
Dichrorampha_plumbagana	Tortricidae
Notocelia_incarnatana	Tortricidae
Lepteucosma_huebneriana	Tortricidae
Pelochrista_hepatariana	Tortricidae
Pelochrista_subtiliana	Tortricidae
Pelochrista_caecimaculana	Tortricidae
Pelochrista_mollitana	Tortricidae
Selania_resedana	Tortricidae
Grapholita_discretana	Tortricidae
Grapholita_lobarzewskii	Tortricidae
Eucosma_catoptrana	Tortricidae
Eucosma_krygeri	Tortricidae
Eucosma_wimmerana	Tortricidae
Eucosma_aspidiscana	Tortricidae
Eucosma_metzneriana	Tortricidae
Epinotia_tetraquetrana	Tortricidae
Zeiraphera_rufimitrana	Tortricidae
Rhyacionia_buoliana	Tortricidae
Clavigesta_purdeyi	Tortricidae
Clavigesta_sylvestrana	Tortricidae
Rhyacionia_hafneri	Tortricidae
Rhyacionia_pinivorana	Tortricidae
Pelochrista_arabescana	Tortricidae
Pelochrista_huebneriana	Tortricidae
Grapholita_fissana	Tortricidae
Grapholita_janthinana	Tortricidae
Grapholita_tenebrosana	Tortricidae
Epinotia_signatana	Tortricidae
Gibberifera_simplana	Tortricidae
Eulia_ministrana	Tortricidae
Zeiraphera_griseana	Tortricidae
Rhyacionia_pinicolana	Tortricidae
Grapholita_gemmiferana	Tortricidae
Grapholita_jungiella	Tortricidae
Epinotia_crenana	Tortricidae
Eudemis_porphyrana	Tortricidae
Eudemis_profundana	Tortricidae
Epinotia_tenerana	Tortricidae
Gypsonoma_aceriana	Tortricidae
Gypsonoma_nitidulana	Tortricidae
Zeiraphera_ratzeburgiana	Tortricidae
Zeiraphera_isertana	Tortricidae
Rhyacionia_duplana	Tortricidae
Rhyacionia_logaea	Tortricidae
Grapholita_orobana	Tortricidae
Grapholita_lunulana	Tortricidae
Grapholita_caecana	Tortricidae
Cydia_leguminana	Tortricidae
Epinotia_bilunana	Tortricidae
Epinotia_subocellana	Tortricidae
Epinotia_nanana	Tortricidae
Epinotia_pusillana	Tortricidae
Gypsonoma_imparana	Tortricidae
Gypsonoma_minutana	Tortricidae
Grapholita_aureolana	Tortricidae
Cydia_nigricana	Tortricidae
Lathronympha_strigana	Tortricidae
Cydia_corollana	Tortricidae
Epinotia_sordidana	Tortricidae
Epinotia_maculana	Tortricidae
Epinotia_fraternana	Tortricidae
Gypsonoma_sociana	Tortricidae
Rhopobota_naevana	Tortricidae
Eucosmomorpha_albersana	Tortricidae
Grapholita_coronillana	Tortricidae
Cydia_microgrammana	Tortricidae
Epinotia_indecorana	Tortricidae
Epinotia_trigonella	Tortricidae
Epinotia_caprana	Tortricidae
Epinotia_gimmerthaliana	Tortricidae
Epinotia_ramella	Tortricidae
Gypsonoma_dealbana	Tortricidae
Gypsonoma_oppressana	Tortricidae
Rhopobota_ustomaculana	Tortricidae
Corticivora_piniana	Tortricidae
Pseudargyrotoza_conwagana	Tortricidae
Acroclita_subsequana	Tortricidae
Enarmonia_formosana	Tortricidae
Pseudophiaris_sappadana	Tortricidae
Grapholita_compositella	Tortricidae
Grapholita_pallifrontana	Tortricidae
Cydia_ulicetana	Tortricidae
Cydia_medicaginis	Tortricidae
Cydia_succedana	Tortricidae
Pammene_ochsenheimeriana	Tortricidae
Pammene_germmana	Tortricidae
Cydia_splendana	Tortricidae
Cydia_fagiglandana	Tortricidae
Epinotia_brunnichana	Tortricidae
Epinotia_solandriana	Tortricidae
Epinotia_cruciana	Tortricidae
Epinotia_mercuriana	Tortricidae
Epinotia_nisella	Tortricidae
Epinotia_cinereana	Tortricidae
Epinotia_immundana	Tortricidae
Rhopobota_myrtillana	Tortricidae
Rhopobota_stagnana	Tortricidae
Capua_vulgana	Tortricidae
Spatalistis_bifasciana	Tortricidae
Olindia_schumacherana	Tortricidae
Ancylis_tineana	Tortricidae
Cydia_grunertiana	Tortricidae
Cydia_pactolana	Tortricidae
Epinotia_rubiginosana	Tortricidae
Periclepsis_cinctana	Tortricidae
Sparganothis_rubicundana	Tortricidae
Ditula_angustiorana	Tortricidae
Selania_leplastriana	Tortricidae
Ancylis_achatana	Tortricidae
Pammene_luedersiana	Tortricidae
Pammene_splendidulana	Tortricidae
Pammene_spiniana	Tortricidae
Pammene_populana	Tortricidae
Pammene_rhediella	Tortricidae
Cydia_strobilella	Tortricidae
Cydia_servillana	Tortricidae
Epinotia_nigricana	Tortricidae
Epinotia_nemorivaga	Tortricidae
Epinotia_granitana	Tortricidae
Epinotia_tedella	Tortricidae
Epinotia_pygmaeana	Tortricidae
Epinotia_subsequana	Tortricidae
Adoxophyes_orana	Tortricidae
Retinia_resinella	Tortricidae
Phalonidia_gilvicomana	Tortricidae
Phalonidia_curvistrigana	Tortricidae
Diceratura_infantana	Tortricidae
Aethes_rutilana	Tortricidae
Phtheochroa_drenowskyi	Tortricidae
Phtheochroa_frigidana	Tortricidae
Cochylimorpha_cultana	Tortricidae
Philedonides_lunana	Tortricidae
Philedonides_rhombicana	Tortricidae
Aleimma_loeflingiana	Tortricidae
Tortrix_viridana	Tortricidae
Sparganothis_praecana	Tortricidae
Sparganothis_pilleriana	Tortricidae
Neosphaleroptera_nubilana	Tortricidae
Cnephasia_heinemanni	Tortricidae
Cnephasia_sedana	Tortricidae
Archips_oporana	Tortricidae
Ancylis_selenana	Tortricidae
Endothenia_quadrimaculana	Tortricidae
Epinotia_festivana	Tortricidae
Bactra_venosana	Tortricidae
Strophedra_weirana	Tortricidae
Strophedra_nitidana	Tortricidae
Cydia_illutana	Tortricidae
Cydia_cosmophorana	Tortricidae
Pseudococcyx_posticana	Tortricidae
Pseudococcyx_turionella	Tortricidae
Pseudococcyx_mughiana	Tortricidae
Aethes_aurofasciana	Tortricidae
Aethes_decimana	Tortricidae
Phtheochroa_duponchelana	Tortricidae
Phtheochroa_inopiana	Tortricidae
Phtheochroa_vulneratana	Tortricidae
Cochylimorpha_erlebachi	Tortricidae
Cochylimorpha_hilarana	Tortricidae
Eupoecilia_ambiguella	Tortricidae
Acleris_rhombana	Tortricidae
Acleris_holmiana	Tortricidae
Doloploca_punctulana	Tortricidae
Archips_betulana	Tortricidae
Archips_podana	Tortricidae
Ancylis_uncella	Tortricidae
Ancylis_unguicella	Tortricidae
Ancylis_unculana	Tortricidae
Ancylis_subarcuana	Tortricidae
Ancylis_obtusana	Tortricidae
Ancylis_laetana	Tortricidae
Celypha_aurofasciana	Tortricidae
Pammene_fasciana	Tortricidae
Pammene_herrichiana	Tortricidae
Pammene_agnotana	Tortricidae
Pammene_luculentana	Tortricidae
Cydia_cognatana	Tortricidae
Cydia_amplana	Tortricidae
Eriopsela_quadrana	Tortricidae
Epinotia_kochiana	Tortricidae
Aethes_margarotana	Tortricidae
Aethes_williana	Tortricidae
Phalonidia_contractana	Tortricidae
Phalonidia_manniana	Tortricidae
Phalonidia_udana	Tortricidae
Phalonidia_albipalpana	Tortricidae
Phalonidia_affinitana	Tortricidae
Cochylis_posterana	Tortricidae
Cochylis_pallidana	Tortricidae
Phtheochroa_sodaliana	Tortricidae
Phtheochroa_rugosana	Tortricidae
Prochlidonia_amiantana	Tortricidae
Fulvoclysia_nerminae	Tortricidae
Eupoecilia_angustana	Tortricidae
Eupoecilia_sanguisorbana	Tortricidae
Acleris_forsskaleana	Tortricidae
Acleris_bergmanniana	Tortricidae
Argyrotaenia_ljungiana	Tortricidae
Ptycholomoides_aeriferana	Tortricidae
Ptycholoma_lecheana	Tortricidae
Aphelia_viburniana	Tortricidae
Ancylis_sparulana	Tortricidae
Ancylis_diminutana	Tortricidae
Ancylis_geminana	Tortricidae
Ancylis_kenneli	Tortricidae
Ancylis_comptana	Tortricidae
Ancylis_mitterbacheriana	Tortricidae
Ancylis_upupana	Tortricidae
Endothenia_marginana	Tortricidae
Endothenia_ericetana	Tortricidae
Isotrias_cuencana	Tortricidae
Isotrias_rectifasciana	Tortricidae
Hedya_dimidiana	Tortricidae
Bactra_furfurana	Tortricidae
Bactra_lancealana	Tortricidae
Bactra_robustana	Tortricidae
Pammene_giganteana	Tortricidae
Pammene_laserpitiana	Tortricidae
Pammene_aurita	Tortricidae
Cydia_conicolana	Tortricidae
Cydia_cornucopiae	Tortricidae
Thiodia_torridana	Tortricidae
Hedya_ochroleucana	Tortricidae
Thiodia_citrana	Tortricidae
Thiodia_trochilana	Tortricidae
Aethes_ardezana	Tortricidae
Cochylis_epilinana	Tortricidae
Agapeta_zoegana	Tortricidae
Agapeta_hamana	Tortricidae
Cochylimorpha_alternana	Tortricidae
Cochylimorpha_straminea	Tortricidae
Acleris_scabrana	Tortricidae
Xerocnephasia_rigana	Tortricidae
Archips_crataegana	Tortricidae
Paramesia_gnomana	Tortricidae
Ancylis_myrtillana	Tortricidae
Endothenia_ustulana	Tortricidae
Endothenia_nigricostana	Tortricidae
Endothenia_pullana	Tortricidae
Lobesia_abscisana	Tortricidae
Hedya_pruniana	Tortricidae
Hedya_nubiferana	Tortricidae
Hedya_salicella	Tortricidae
Pseudosciaphila_branderiana	Tortricidae
Bactra_lacteana	Tortricidae
Bactra_suedana	Tortricidae
Pammene_albuginana	Tortricidae
Pammene_suspectana	Tortricidae
Pammene_ignorata	Tortricidae
Pammene_argyrana	Tortricidae
Pammene_insulana	Tortricidae
Pammene_gallicana	Tortricidae
Pammene_aurana	Tortricidae
Pammene_trauniana	Tortricidae
Pammene_regiana	Tortricidae
Cydia_duplicana	Tortricidae
Cydia_pomonella	Tortricidae
Cydia_inquinatana	Tortricidae
Aethes_deutschiana	Tortricidae
Aethes_moribundana	Tortricidae
Aethes_bilbaensis	Tortricidae
Gynnidomorpha_vectisana	Tortricidae
Gynnidomorpha_alismana	Tortricidae
Gynnidomorpha_luridana	Tortricidae
Cochylis_roseana	Tortricidae
Cochylis_flaviciliana	Tortricidae
Cochylis_atricapitana	Tortricidae
Cochylis_nana	Tortricidae
Acleris_cristana	Tortricidae
Cnephasia_pasiuana	Tortricidae
Archips_rosana	Tortricidae
Archips_xylosteana	Tortricidae
Cacoecimorpha_pronubana	Tortricidae
Ancylis_apicella	Tortricidae
Endothenia_gentianaeana	Tortricidae
Endothenia_oblongana	Tortricidae
Lobesia_artemisiana	Tortricidae
Lobesia_bicinctana	Tortricidae
Lobesia_virulenta	Tortricidae
Lobesia_reliquana	Tortricidae
Lobesia_littoralis	Tortricidae
Lobesia_limoniana	Tortricidae
Celypha_flavipalpana	Tortricidae
Metendothenia_atropunctana	Tortricidae
Aterpia_chalybeia	Tortricidae
Aterpia_anderreggana	Tortricidae
Aterpia_sieversiana	Tortricidae
Aterpia_corticana	Tortricidae
Pammene_obscurana	Tortricidae
Pammene_clanculana	Tortricidae
Cydia_coniferana	Tortricidae
Cydia_indivisa	Tortricidae
Aethes_tesserana	Tortricidae
Aethes_hartmanniana	Tortricidae
Aethes_fennicana	Tortricidae
Gynnidomorpha_minimana	Tortricidae
Gynnidomorpha_permixtana	Tortricidae
Cochylidia_rupicola	Tortricidae
Acleris_umbrana	Tortricidae
Acleris_schalleriana	Tortricidae
Acleris_lacordairana	Tortricidae
Acleris_fimbriana	Tortricidae
Eana_derivana	Tortricidae
Eana_canescana	Tortricidae
Cnephasia_stephensiana	Tortricidae
Cnephasia_incertana	Tortricidae
Cnephasia_longana	Tortricidae
Cnephasia_genitalana	Tortricidae
Pandemis_corylana	Tortricidae
Pandemis_cinnamomeana	Tortricidae
Pandemis_dumetana	Tortricidae
Epagoge_grotiana	Tortricidae
Philedone_gerningana	Tortricidae
Lozotaenia_cupidinana	Tortricidae
Choristoneura_albaniana	Tortricidae
Choristoneura_hebenstreitella	Tortricidae
Choristoneura_murinana	Tortricidae
Choristoneura_diversana	Tortricidae
Ancylis_paludana	Tortricidae
Cymolomia_hartigiana	Tortricidae
Pseudohermenias_abietana	Tortricidae
Celypha_rurestrana	Tortricidae
Argyroploce_arbutella	Tortricidae
Apotomis_turbidana	Tortricidae
Apotomis_lemniscatana	Tortricidae
Apotomis_algidana	Tortricidae
Aethes_kyrkii	Tortricidae
Aethes_triangulana	Tortricidae
Aethes_francillana	Tortricidae
Falseuncaria_degreyana	Tortricidae
Falseuncaria_ruficiliana	Tortricidae
Cochylidia_moguntiana	Tortricidae
Cochylis_molliculana	Tortricidae
Acleris_roscidana	Tortricidae
Acleris_literana	Tortricidae
Acleris_quercinana	Tortricidae
Acleris_lorquiniana	Tortricidae
Eana_penziana	Tortricidae
Eana_nervana	Tortricidae
Eana_freii	Tortricidae
Eana_osseana	Tortricidae
Eana_incanana	Tortricidae
Eana_argentana	Tortricidae
Cnephasia_asseclana	Tortricidae
Cnephasia_cupressivorana	Tortricidae
Clepsis_rurinana	Tortricidae
Clepsis_illustrana	Tortricidae
Clepsis_spectrana	Tortricidae
Clepsis_neglectana	Tortricidae
Clepsis_consimilana	Tortricidae
Pandemis_heparana	Tortricidae
Pandemis_cerasana	Tortricidae
Aphelia_ferugana	Tortricidae
Aphelia_ochreana	Tortricidae
Lozotaenia_forsterana	Tortricidae
Syndemis_musculana	Tortricidae
Dichelia_histrionana	Tortricidae
Ancylis_badiana	Tortricidae
Ancylis_habeleri	Tortricidae
Ancylis_rhenana	Tortricidae
Celypha_siderana	Tortricidae
Stictea_mygindiana	Tortricidae
Aethes_rubigana	Tortricidae
Aethes_cnicana	Tortricidae
Aethes_beatricella	Tortricidae
Aethes_dilucidana	Tortricidae
Cochylidia_richteriana	Tortricidae
Cochylis_dubitana	Tortricidae
Cochylis_hybridella	Tortricidae
Acleris_permutana	Tortricidae
Acleris_variegana	Tortricidae
Acleris_maccana	Tortricidae
Acleris_hyemana	Tortricidae
Acleris_lipsiana	Tortricidae
Acleris_rufana	Tortricidae
Acleris_sparsana	Tortricidae
Acleris_effractana	Tortricidae
Acleris_emargana	Tortricidae
Acleris_kochiella	Tortricidae
Acleris_logiana	Tortricidae
Sphaleroptera_dentana	Tortricidae
Tortricodes_alternella	Tortricidae
Cnephasia_alticolana	Tortricidae
Cnephasia_zangheriana	Tortricidae
Cnephasia_graecana	Tortricidae
Cnephasia_communana	Tortricidae
Clepsis_pallidana	Tortricidae
Clepsis_dumicolana	Tortricidae
Clepsis_siciliana	Tortricidae
Aphelia_unitana	Tortricidae
Aphelia_paleana	Tortricidae
Pelatea_klugiana	Tortricidae
Pristerognatha_fuligana	Tortricidae
Pristerognatha_penthinana	Tortricidae
Celypha_rufana	Tortricidae
Celypha_cespitana	Tortricidae
Celypha_capreolana	Tortricidae
Apotomis_moestana	Tortricidae
Apotomis_infida	Tortricidae
Apotomis_sauciana	Tortricidae
Apotomis_lineana	Tortricidae
Apotomis_betuletana	Tortricidae
Apotomis_sororculana	Tortricidae
Apotomis_boreana	Tortricidae
Apotomis_inundana	Tortricidae
Apotomis_capreana	Tortricidae
Apotomis_demissana	Tortricidae
Apotomis_fraterculana	Tortricidae
Apotomis_semifasciana	Tortricidae
Aethes_kindermanniana	Tortricidae
Aethes_smeathmanniana	Tortricidae
Aethes_languidana	Tortricidae
Aethes_margaritana	Tortricidae
Cochylidia_subroseana	Tortricidae
Acleris_laterana	Tortricidae
Acleris_nigrilineana	Tortricidae
Acleris_abietana	Tortricidae
Acleris_hastiana	Tortricidae
Acleris_hippophaeana	Tortricidae
Acleris_shepherdana	Tortricidae
Acleris_aspersana	Tortricidae
Sphaleroptera_occidentana	Tortricidae
Exapate_duratella	Tortricidae
Exapate_congelatella	Tortricidae
Clepsis_steineriana	Tortricidae
Lozotaeniodes_cupressana	Tortricidae
Lozotaeniodes_formosana	Tortricidae
Clepsis_senecionana	Tortricidae
Celypha_tiedemanniana	Tortricidae
Celypha_rosaceana	Tortricidae
Celypha_striana	Tortricidae
Argyroploce_noricana	Tortricidae
Argyroploce_aquilonana	Tortricidae
Cochylidia_heydeniana	Tortricidae
Cochylidia_implicitana	Tortricidae
Acleris_implexana	Tortricidae
Acleris_obtusana	Tortricidae
Acleris_notana	Tortricidae
Acleris_ferrugana	Tortricidae
Acleris_comariana	Tortricidae
Acleris_caledoniana	Tortricidae
Sphaleroptera_alpicolana	Tortricidae
Sphaleroptera_adamelloi	Tortricidae
Sphaleroptera_orientana	Tortricidae
Clepsis_balcanica	Tortricidae
Clepsis_rogana	Tortricidae
Clepsis_nybomi	Tortricidae
Olethreutes_subtilana	Tortricidae
Olethreutes_arcuella	Tortricidae
Selenodes_karelica	Tortricidae
Celypha_woodiana	Tortricidae
Phiaris_helveticana	Tortricidae
Celypha_lacunana	Tortricidae
Argyroploce_roseomaculana	Tortricidae
Argyroploce_concretana	Tortricidae
Argyroploce_externa	Tortricidae
Argyroploce_lediana	Tortricidae
Clepsis_lindebergi	Tortricidae
Epiphyas_postvittana	Tortricidae
Piniphila_bifasciana	Tortricidae
Phiaris_dissolutana	Tortricidae
Celypha_rivulana	Tortricidae
Phiaris_heinrichana	Tortricidae
Capricornia_boisduvaliana	Tortricidae
Phiaris_scoriana	Tortricidae
Phiaris_stibiana	Tortricidae
Phiaris_turfosana	Tortricidae
Phiaris_septentrionana	Tortricidae
Phiaris_schulziana	Tortricidae
Phiaris_bipunctana	Tortricidae
Orthotaenia_undulana	Tortricidae
Phiaris_umbrosana	Tortricidae
Phiaris_micana	Tortricidae
Phiaris_palustrana	Tortricidae
Phiaris_obsoletana	Tortricidae
Phiaris_metallicana	Tortricidae
Cedestis_subfasciella	Yponomeutidae
Cedestis_gysseleniella	Yponomeutidae
Ocnerostoma_piniariella	Yponomeutidae
Ocnerostoma_friesei	Yponomeutidae
Yponomeuta_malinellus	Yponomeutidae
Yponomeuta_rorrella	Yponomeutidae
Yponomeuta_irrorella	Yponomeutidae
Yponomeuta_padella	Yponomeutidae
Yponomeuta_evonymella	Yponomeutidae
Yponomeuta_cagnagella	Yponomeutidae
Yponomeuta_plumbella	Yponomeutidae
Kessleria_klimeschi	Yponomeutidae
Kessleria_inexpectata	Yponomeutidae
Kessleria_insubrica	Yponomeutidae
Kessleria_albescens	Yponomeutidae
Kessleria_helvetica	Yponomeutidae
Kessleria_hauderi	Yponomeutidae
Kessleria_burmanni	Yponomeutidae
Kessleria_alpicella	Yponomeutidae
Zelleria_hepariella	Yponomeutidae
Zelleria_oleastrella	Yponomeutidae
Paradoxus_osyridellus	Yponomeutidae
Kessleria_albomaculata	Yponomeutidae
Kessleria_caflischiella	Yponomeutidae
Kessleria_petrobiella	Yponomeutidae
Kessleria_nivescens	Yponomeutidae
Kessleria_wehrlii	Yponomeutidae
Kessleria_alternans	Yponomeutidae
Euhyponomeuta_stannella	Yponomeutidae
Pseudoswammerdamia_combinella	Yponomeutidae
Kessleria_saxifragae	Yponomeutidae
Kessleria_fasciapennella	Yponomeutidae
Euhyponomeutoides_albithoracellus	Yponomeutidae
Euhyponomeutoides_ribesiella	Yponomeutidae
Swammerdamia_pyrella	Yponomeutidae
Swammerdamia_passerella	Yponomeutidae
Yponomeuta_sedella	Yponomeutidae
Swammerdamia_compunctella	Yponomeutidae
Swammerdamia_caesiella	Yponomeutidae
Scythropia_crataegella	Yponomeutidae
Paraswammerdamia_nebulella	Yponomeutidae
Paraswammerdamia_albicapitella	Yponomeutidae
Paraswammerdamia_lapponica	Yponomeutidae
Paraswammerdamia_conspersella	Yponomeutidae
Ypsolopha_mucronella	Ypsolophidae
Phrealcia_eximiella	Ypsolophidae
Ypsolopha_dentella	Ypsolophidae
Ypsolopha_falcella	Ypsolophidae
Ypsolopha_nemorella	Ypsolophidae
Ypsolopha_lucella	Ypsolophidae
Ypsolopha_sarmaticella	Ypsolophidae
Ypsolopha_instabilella	Ypsolophidae
Ypsolopha_asperella	Ypsolophidae
Ypsolopha_leuconotella	Ypsolophidae
Ypsolopha_sequella	Ypsolophidae
Ypsolopha_horridella	Ypsolophidae
Ypsolopha_scabrella	Ypsolophidae
Ypsolopha_vittella	Ypsolophidae
Ypsolopha_chazariella	Ypsolophidae
Ochsenheimeria_vacculella	Ypsolophidae
Ochsenheimeria_urella	Ypsolophidae
Ypsolopha_parenthesella	Ypsolophidae
Ypsolopha_ustella	Ypsolophidae
Ypsolopha_sylvella	Ypsolophidae
Ypsolopha_alpella	Ypsolophidae
Zygaena_fausta	Zygaenidae
Aglaope_infausta	Zygaenidae
Zygaena_minos	Zygaenidae
Zygaena_osterodensis	Zygaenidae
Zygaena_ephialtes	Zygaenidae
Zygaena_brizae	Zygaenidae
Zygaena_laeta	Zygaenidae
Zygaena_loti	Zygaenidae
Zygaena_exulans	Zygaenidae
Zygaena_lonicerae	Zygaenidae
Zygaena_filipendulae	Zygaenidae
Zygaena_carniolica	Zygaenidae
Zygaena_transalpina	Zygaenidae
Zygaena_punctum	Zygaenidae
Zygaena_angelicae	Zygaenidae
Zygaena_rubicunda	Zygaenidae
Zygaena_trifolii	Zygaenidae
Zygaena_purpuralis	Zygaenidae
Zygaena_viciae	Zygaenidae
Zygaena_lavandulae	Zygaenidae
Zygaena_sedi	Zygaenidae
Theresimima_ampellophaga	Zygaenidae
Rhagades_predotae	Zygaenidae
Rhagades_pruni	Zygaenidae
Jordanita_subsolana	Zygaenidae
Adscita_albanica	Zygaenidae
Adscita_geryon	Zygaenidae
Jordanita_notata	Zygaenidae
Jordanita_volgensis	Zygaenidae
Jordanita_budensis	Zygaenidae
Adscita_jordani	Zygaenidae
Adscita_bolivari	Zygaenidae
Adscita_mannii	Zygaenidae
Jordanita_chloros	Zygaenidae
Jordanita_tenuicornis	Zygaenidae
Jordanita_graeca	Zygaenidae
Jordanita_globulariae	Zygaenidae
Jordanita_hispanica	Zygaenidae
Jordanita_vartianae	Zygaenidae
Adscita_schmidti	Zygaenidae
Adscita_alpina	Zygaenidae
Adscita_italica	Zygaenidae
Adscita_statices	Zygaenidae
